,name,geo_type,name_cbsa,popestimate2010,popestimate2020,n_pop_chg_2010_2020,births_2010_2020,deaths_2010_2020,natural_increase_2010_2020,int_migration_2010_2020,dom_migration_2010_2020,net_migration_2010_2020,dom_migration_rate_1020,int_migration_rate_1020
0,"Abilene, TX",Metropolitan Statistical Area,"Abilene, TX Metro Area",165590,173185,7933,24162,17347,6815,3213,-2057,1156,-0.012422247720272964,0.019403345612657767
1,"Akron, OH",Metropolitan Statistical Area,"Akron, OH Metro Area",703056,701449,-1766,76396,74134,2262,14723,-18377,-3654,-0.026138742859743748,0.0209414328303862
2,"Albany, GA",Metropolitan Statistical Area,"Albany, GA Metro Area",154155,145206,-8827,20510,15136,5374,911,-15217,-14306,-0.09871233498751256,0.005909636404917129
3,"Albany-Lebanon, OR",Metropolitan Statistical Area,"Albany-Lebanon, OR Metro Area",116887,131054,14373,15074,12929,2145,214,12059,12273,0.10316801697365832,0.0018308280647120726
4,"Albany-Schenectady-Troy, NY",Metropolitan Statistical Area,"Albany-Schenectady-Troy, NY Metro Area",871101,878550,7837,91837,81373,10464,17611,-19809,-2198,-0.022740187417991716,0.02021694384462881
5,"Albuquerque, NM",Metropolitan Statistical Area,"Albuquerque, NM Metro Area",889581,923630,36574,104702,75732,28970,13584,-5524,8060,-0.006209664999589694,0.015270110310359597
6,"Alexandria, LA",Metropolitan Statistical Area,"Alexandria, LA Metro Area",154088,150821,-3089,20794,16998,3796,825,-7637,-6812,-0.049562587612273515,0.005354083380925185
7,"Allentown-Bethlehem-Easton, PA-NJ",Metropolitan Statistical Area,"Allentown-Bethlehem-Easton, PA-NJ Metro Area",821768,846399,25304,88060,83833,4227,26552,-4933,21619,-0.006002910797207971,0.032310822519251166
8,"Altoona, PA",Metropolitan Statistical Area,"Altoona, PA Metro Area",127049,121007,-6114,13050,16583,-3533,287,-2769,-2482,-0.0217947406118899,0.0022589709482168296
9,"Amarillo, TX",Metropolitan Statistical Area,"Amarillo, TX Metro Area",252666,265761,13824,37257,24007,13250,6274,-5800,474,-0.022955205686558542,0.02483120008232212
10,"Ames, IA",Metropolitan Statistical Area,"Ames, IA Metro Area",115932,124514,8664,12253,8360,3893,7398,-2667,4731,-0.02300486492081565,0.06381326984784184
11,"Anchorage, AK",Metropolitan Statistical Area,"Anchorage, AK Metro Area",383491,397308,16075,59705,23339,36366,10461,-31122,-20661,-0.08115444691009698,0.02727834551527937
12,"Ann Arbor, MI",Metropolitan Statistical Area,"Ann Arbor, MI Metro Area",345980,366473,21056,37579,23063,14516,19183,-12452,6731,-0.03599051968321868,0.05544540146829297
13,"Anniston-Oxford, AL",Metropolitan Statistical Area,"Anniston-Oxford, AL Metro Area",118420,113469,-5064,13556,14808,-1252,540,-4306,-3766,-0.0363621009964533,0.004560040533693633
14,"Appleton, WI",Metropolitan Statistical Area,"Appleton, WI Metro Area",225884,238975,13380,28640,17600,11040,1958,525,2483,0.002324201802695189,0.008668165961289866
15,"Asheville, NC",Metropolitan Statistical Area,"Asheville, NC Metro Area",425365,466634,41770,44832,50760,-5928,2017,45351,47368,0.10661667038896007,0.004741809974962679
16,"Athens-Clarke County, GA",Metropolitan Statistical Area,"Athens-Clarke County, GA Metro Area",193436,214759,22201,22561,14493,8068,4200,9808,14008,0.050704108852540376,0.02171260778758866
17,"Atlanta-Sandy Springs-Alpharetta, GA",Metropolitan Statistical Area,"Atlanta-Sandy Springs-Alpharetta, GA Metro Area",5302733,6087762,801073,742606,373246,369360,161041,269844,430885,0.050887721482488366,0.030369434025812724
18,"Atlantic City-Hammonton, NJ",Metropolitan Statistical Area,"Atlantic City-Hammonton, NJ Metro Area",274654,262945,-11587,31062,27578,3484,7493,-22691,-15198,-0.0826166740699207,0.02728159793776897
19,"Auburn-Opelika, AL",Metropolitan Statistical Area,"Auburn-Opelika, AL Metro Area",140815,166831,26531,18526,10814,7712,5129,13498,18627,0.09585626531264424,0.03642367645492313
20,"Augusta-Richmond County, GA-SC",Metropolitan Statistical Area,"Augusta-Richmond County, GA-SC Metro Area",566712,614312,49419,76077,55661,20416,7024,21915,28939,0.03867043577690255,0.012394302573441185
21,"Austin-Round Rock-Georgetown, TX",Metropolitan Statistical Area,"Austin-Round Rock-Georgetown, TX Metro Area",1727514,2295303,578996,266507,102543,163964,67765,342570,410335,0.19830230029973708,0.03922688904402511
22,"Bakersfield, CA",Metropolitan Statistical Area,"Bakersfield, CA Metro Area",841365,901362,61743,140814,60952,79862,5264,-23200,-17936,-0.027574239479892796,0.006256499854403261
23,"Baltimore-Columbia-Towson, MD",Metropolitan Statistical Area,"Baltimore-Columbia-Towson, MD Metro Area",2715794,2800189,89588,342158,251744,90414,69453,-68456,997,-0.02520662465562557,0.02557373644687336
24,"Bangor, ME",Metropolitan Statistical Area,"Bangor, ME Metro Area",153864,151655,-2277,14727,16299,-1572,1236,-1851,-615,-0.012030104507877086,0.008033068164092966
25,"Barnstable Town, MA",Metropolitan Statistical Area,"Barnstable Town, MA Metro Area",215909,213164,-2719,15862,29924,-14062,3821,7747,11568,0.035880857212992515,0.0176972706093771
26,"Baton Rouge, LA",Metropolitan Statistical Area,"Baton Rouge, LA Metro Area",827673,858571,32627,114917,72984,41933,10412,-19740,-9328,-0.023849998731383045,0.012579847355175292
27,"Battle Creek, MI",Metropolitan Statistical Area,"Battle Creek, MI Metro Area",135953,133580,-2570,16516,15414,1102,2428,-6085,-3657,-0.04475811493677962,0.017859113075842387
28,"Bay City, MI",Metropolitan Statistical Area,"Bay City, MI Metro Area",107678,102387,-5386,10569,12501,-1932,254,-3656,-3402,-0.033953082338082065,0.002358884823269377
29,"Beaumont-Port Arthur, TX",Metropolitan Statistical Area,"Beaumont-Port Arthur, TX Metro Area",389257,391310,2559,54246,41097,13149,5605,-16163,-10558,-0.041522695802516066,0.014399227245752806
30,"Beckley, WV",Metropolitan Statistical Area,"Beckley, WV Metro Area",124950,114982,-9928,13910,17333,-3423,598,-7061,-6463,-0.056510604241696676,0.0047859143657462975
31,"Bellingham, WA",Metropolitan Statistical Area,"Bellingham, WA Metro Area",201549,231016,29870,22952,16707,6245,3982,19658,23640,0.09753459456509336,0.019756982173069572
32,"Bend, OR",Metropolitan Statistical Area,"Bend, OR Metro Area",157744,201769,44041,18125,14644,3481,-95,40320,40225,0.2556040166345471,-0.0006022416066538189
33,"Billings, MT",Metropolitan Statistical Area,"Billings, MT Metro Area",167580,183799,16634,21528,17014,4514,1073,11053,12126,0.06595655806182121,0.006402912042009786
34,"Binghamton, NY",Metropolitan Statistical Area,"Binghamton, NY Metro Area",251486,237324,-14398,25275,26344,-1069,4160,-17562,-13402,-0.06983291316415229,0.01654167627621418
35,"Birmingham-Hoover, AL",Metropolitan Statistical Area,"Birmingham-Hoover, AL Metro Area",1061728,1091921,30883,138842,111667,27175,9309,-4989,4320,-0.00469894360890925,0.008767782332198076
36,"Bismarck, ND",Metropolitan Statistical Area,"Bismarck, ND Metro Area",111119,129641,19016,17506,10330,7176,1280,10310,11590,0.09278341237772117,0.011519182138068195
37,"Blacksburg-Christiansburg, VA",Metropolitan Statistical Area,"Blacksburg-Christiansburg, VA Metro Area",163139,167244,4285,14992,14504,488,5736,-1925,3811,-0.011799753584366706,0.035160200810351906
38,"Bloomington, IL",Metropolitan Statistical Area,"Bloomington, IL Metro Area",169815,171256,1678,20671,12100,8571,6160,-13143,-6983,-0.07739598975355534,0.036274769602214166
39,"Bloomington, IN",Metropolitan Statistical Area,"Bloomington, IN Metro Area",160140,169052,9522,15484,11985,3499,9551,-3498,6053,-0.0218433870363432,0.059641563631822166
40,"Bloomsburg-Berwick, PA",Metropolitan Statistical Area,"Bloomsburg-Berwick, PA Metro Area",85653,82884,-2668,8141,9510,-1369,593,-1830,-1237,-0.02136527617246331,0.006923283481022264
41,"Boise City, ID",Metropolitan Statistical Area,"Boise City, ID Metro Area",617899,770353,153787,86825,47962,38863,7178,107361,114539,0.1737516972838603,0.011616785267495171
42,"Boston-Cambridge-Newton, MA-NH",Metropolitan Statistical Area,"Boston-Cambridge-Newton, MA-NH Metro Area",4566448,4878211,325613,524112,376593,147519,309878,-128613,181265,-0.02816477927702232,0.06785974569293245
43,"Boulder, CO",Metropolitan Statistical Area,"Boulder, CO Metro Area",295056,327171,32611,28618,18203,10415,8800,13329,22129,0.04517447535383114,0.029824846808741395
44,"Bowling Green, KY",Metropolitan Statistical Area,"Bowling Green, KY Metro Area",159352,180751,22133,21854,15422,6432,5322,10366,15688,0.06505095637331193,0.033397760931773685
45,"Bremerton-Silverdale-Port Orchard, WA",Metropolitan Statistical Area,"Bremerton-Silverdale-Port Orchard, WA Metro Area",251696,272787,21644,30811,22396,8415,2663,10476,13139,0.04162163880236476,0.0105802237619986
46,"Bridgeport-Stamford-Norwalk, CT",Metropolitan Statistical Area,"Bridgeport-Stamford-Norwalk, CT Metro Area",919371,942426,25516,102311,68987,33324,49354,-57114,-7760,-0.062122907944670874,0.0536823545663285
47,"Brownsville-Harlingen, TX",Metropolitan Statistical Area,"Brownsville-Harlingen, TX Metro Area",407608,424180,17966,71420,26882,44538,3277,-30003,-26726,-0.07360748562344213,0.008039587054228572
48,"Brunswick, GA",Metropolitan Statistical Area,"Brunswick, GA Metro Area",112524,119157,6786,13257,12102,1155,856,4779,5635,0.04247093953289965,0.007607266005474387
49,"Buffalo-Cheektowaga, NY",Metropolitan Statistical Area,"Buffalo-Cheektowaga, NY Metro Area",1135634,1125637,-9971,123684,125060,-1376,25789,-33738,-7949,-0.029708515243467525,0.022708900931109846
50,"Burlington, NC",Metropolitan Statistical Area,"Burlington, NC Metro Area",151437,171346,20186,18788,16815,1973,751,17497,18248,0.11553979542648098,0.004959157933662183
51,"Burlington-South Burlington, VT",Metropolitan Statistical Area,"Burlington-South Burlington, VT Metro Area",211543,221160,9896,22014,16077,5937,6481,-2355,4126,-0.011132488430248224,0.03063679724689543
52,"California-Lexington Park, MD",Metropolitan Statistical Area,"California-Lexington Park, MD Metro Area",105772,114687,9541,14370,8156,6214,1563,1790,3353,0.016923193283666756,0.014777067654955943
53,"Canton-Massillon, OH",Metropolitan Statistical Area,"Canton-Massillon, OH Metro Area",404207,396669,-7739,45144,46447,-1303,1423,-7529,-6106,-0.0186265947893035,0.0035204734207967704
54,"Cape Coral-Fort Myers, FL",Metropolitan Statistical Area,"Cape Coral-Fort Myers, FL Metro Area",620481,790767,172006,67541,70855,-3314,29568,144482,174050,0.2328548335887803,0.04765335280210031
55,"Cape Girardeau, MO-IL",Metropolitan Statistical Area,"Cape Girardeau, MO-IL Metro Area",96459,97120,841,11527,10319,1208,1424,-1776,-352,-0.018411967779056387,0.014762748939964132
56,"Carbondale-Marion, IL",Metropolitan Statistical Area,"Carbondale-Marion, IL Metro Area",139409,135448,-3700,15795,14062,1733,2652,-8183,-5531,-0.058697788521544524,0.019023162062707568
57,"Carson City, NV",Metropolitan Statistical Area,"Carson City, NV Metro Area",54983,56034,765,6019,7322,-1303,-148,2192,2044,0.039866867940999945,-0.0026917410836076604
58,"Casper, WY",Metropolitan Statistical Area,"Casper, WY Metro Area",75477,80815,5367,10903,7370,3533,436,1267,1703,0.016786570743405275,0.005776594194257853
59,"Cedar Rapids, IA",Metropolitan Statistical Area,"Cedar Rapids, IA Metro Area",258449,273885,15938,33328,22304,11024,4070,1038,5108,0.004016266265297989,0.015747787764704063
60,"Chambersburg-Waynesboro, PA",Metropolitan Statistical Area,"Chambersburg-Waynesboro, PA Metro Area",149925,155637,6012,18702,15687,3015,2195,966,3161,0.0064432216108054035,0.014640653660163415
61,"Champaign-Urbana, IL",Metropolitan Statistical Area,"Champaign-Urbana, IL Metro Area",218268,225547,7733,25832,15171,10661,18272,-21326,-3054,-0.09770557296534536,0.08371359979474774
62,"Charleston, WV",Metropolitan Statistical Area,"Charleston, WV Metro Area",277821,254145,-23855,30187,36710,-6523,1285,-18477,-17192,-0.06650685153390133,0.0046252803063843275
63,"Charleston-North Charleston, SC",Metropolitan Statistical Area,"Charleston-North Charleston, SC Metro Area",667495,819705,155058,96045,58028,38017,11247,104474,115721,0.1565165282136945,0.016849564416212857
64,"Charlotte-Concord-Gastonia, NC-SC",Metropolitan Statistical Area,"Charlotte-Concord-Gastonia, NC-SC Metro Area",2250187,2684276,440324,312200,191999,120201,58476,259991,318467,0.11554195273548375,0.02598717351046824
65,"Charlottesville, VA",Metropolitan Statistical Area,"Charlottesville, VA Metro Area",201913,219910,18331,23166,17092,6074,7373,4977,12350,0.02464923011395997,0.03651572707057
66,"Chattanooga, TN-GA",Metropolitan Statistical Area,"Chattanooga, TN-GA Metro Area",529167,569931,41800,64478,57697,6781,4281,30751,35032,0.05811208937821141,0.0080900736440481
67,"Cheyenne, WY",Metropolitan Statistical Area,"Cheyenne, WY Metro Area",92246,100595,8710,12975,8353,4622,731,3325,4056,0.03604492335711034,0.00792446284933764
68,"Chicago-Naperville-Elgin, IL-IN-WI",Metropolitan Statistical Area,"Chicago-Naperville-Elgin, IL-IN-WI Metro Area",9470661,9406638,-54902,1191992,729094,462898,200600,-718600,-518000,-0.07587643565744777,0.021181203719571426
69,"Chico, CA",Metropolitan Statistical Area,"Chico, CA Metro Area",219951,212744,-7261,24618,23905,713,1573,-9408,-7835,-0.042773163113602575,0.007151592854772198
70,"Cincinnati, OH-KY-IN",Metropolitan Statistical Area,"Cincinnati, OH-KY-IN Metro Area",2140963,2232907,95189,280088,202033,78055,37668,-19365,18303,-0.009044995172733016,0.01759395188053226
71,"Clarksville, TN-KY",Metropolitan Statistical Area,"Clarksville, TN-KY Metro Area",274994,314364,40422,52921,22427,30494,7043,2416,9459,0.008785646232281431,0.025611467886572068
72,"Cleveland, TN",Metropolitan Statistical Area,"Cleveland, TN Metro Area",115899,125906,10159,13940,13008,932,1246,7995,9241,0.06898247612145057,0.010750739868333636
73,"Cleveland-Elyria, OH",Metropolitan Statistical Area,"Cleveland-Elyria, OH Metro Area",2075476,2043807,-33463,234158,221913,12245,39864,-84776,-44912,-0.04084653351809416,0.019207160188795244
74,"Coeur d'Alene, ID",Metropolitan Statistical Area,"Coeur d'Alene, ID Metro Area",138860,170628,32162,18081,14096,3985,-359,28493,28134,0.2051922799942388,-0.0025853377502520524
75,"College Station-Bryan, TX",Metropolitan Statistical Area,"College Station-Bryan, TX Metro Area",229460,268224,39559,31676,14488,17188,13596,8681,22277,0.037832301926261656,0.05925215723873443
76,"Colorado Springs, CO",Metropolitan Statistical Area,"Colorado Springs, CO Metro Area",650562,753839,108223,96734,45798,50936,12001,45144,57145,0.06939231003347875,0.018447127253051976
77,"Columbia, MO",Metropolitan Statistical Area,"Columbia, MO Metro Area",190950,210094,19698,24689,14046,10643,6668,2389,9057,0.012511128567687876,0.03492013616129877
78,"Columbia, SC",Metropolitan Statistical Area,"Columbia, SC Metro Area",769682,847397,79919,95965,69393,26572,15661,37883,53544,0.04921902811810592,0.02034736423613908
79,"Columbus, GA-AL",Metropolitan Statistical Area,"Columbus, GA-AL Metro Area",309504,322658,14177,46593,31008,15585,8371,-10426,-2055,-0.033686155913978486,0.027046500206782464
80,"Columbus, IN",Metropolitan Statistical Area,"Columbus, IN Metro Area",76823,84447,7665,10804,7615,3189,4649,-152,4497,-0.0019785741249365428,0.06051573096598675
81,"Columbus, OH",Metropolitan Statistical Area,"Columbus, OH Metro Area",1906408,2138946,236934,278121,161438,116683,67215,53408,120623,0.028014989446120662,0.035257405550123584
82,"Corpus Christi, TX",Metropolitan Statistical Area,"Corpus Christi, TX Metro Area",404675,430217,25202,58518,35699,22819,6457,-4054,2403,-0.010017915611293013,0.015956014085377154
83,"Corvallis, OR",Metropolitan Statistical Area,"Corvallis, OR Metro Area",85577,93239,7658,7378,5893,1485,4789,1358,6147,0.015868749780899073,0.05596129801231639
84,"Crestview-Fort Walton Beach-Destin, FL",Metropolitan Statistical Area,"Crestview-Fort Walton Beach-Destin, FL Metro Area",235939,289468,53600,35488,24231,11257,4790,37099,41889,0.1572397950317667,0.0203018576835538
85,"Cumberland, MD-WV",Metropolitan Statistical Area,"Cumberland, MD-WV Metro Area",103176,96779,-6488,9656,12724,-3068,621,-4014,-3393,-0.03890439637124913,0.00601884159106769
86,"Dallas-Fort Worth-Arlington, TX",Metropolitan Statistical Area,"Dallas-Fort Worth-Arlington, TX Metro Area",6392097,7694138,1327597,1000165,437830,562335,256511,507082,763593,0.07932952206451185,0.040129397285429184
87,"Dalton, GA",Metropolitan Statistical Area,"Dalton, GA Metro Area",142272,143869,1639,19091,12312,6779,319,-5423,-5104,-0.03811712775528565,0.0022421839856050377
88,"Danville, IL",Metropolitan Statistical Area,"Danville, IL Metro Area",81642,74855,-6770,10333,9944,389,253,-7419,-7166,-0.09087234511648416,0.0030988951765022906
89,"Daphne-Fairhope-Foley, AL",Metropolitan Statistical Area,"Daphne-Fairhope-Foley, AL Metro Area",183121,229287,47024,22965,21613,1352,1618,43683,45301,0.238547190109272,0.008835687878506561
90,"Davenport-Moline-Rock Island, IA-IL",Metropolitan Statistical Area,"Davenport-Moline-Rock Island, IA-IL Metro Area",379773,377759,-1933,47732,38710,9022,5971,-16836,-10865,-0.044331745542732115,0.015722550049634913
91,"Dayton-Kettering, OH",Metropolitan Statistical Area,"Dayton-Kettering, OH Metro Area",799706,809248,9968,98062,87927,10135,15951,-15742,209,-0.01968473413979637,0.019946080184467797
92,"Decatur, AL",Metropolitan Statistical Area,"Decatur, AL Metro Area",153956,152740,-1087,18286,17468,818,854,-2686,-1832,-0.017446543168177918,0.005547039413858505
93,"Decatur, IL",Metropolitan Statistical Area,"Decatur, IL Metro Area",110786,103015,-7762,13606,12558,1048,558,-9396,-8838,-0.0848121603812756,0.0050367374939071724
94,"Deltona-Daytona Beach-Ormond Beach, FL",Metropolitan Statistical Area,"Deltona-Daytona Beach-Ormond Beach, FL Metro Area",590527,679948,89665,57686,83613,-25927,13680,101489,115169,0.17186174383220412,0.023165748560184374
95,"Denver-Aurora-Lakewood, CO",Metropolitan Statistical Area,"Denver-Aurora-Lakewood, CO Metro Area",2554588,2991231,447634,352718,178135,174583,61405,208256,269661,0.08152234332894384,0.024037144150054725
96,"Des Moines-West Des Moines, IA",Metropolitan Statistical Area,"Des Moines-West Des Moines, IA Metro Area",608942,707915,101437,94427,50696,43731,14446,42970,57416,0.07056501275983591,0.023723113202899455
97,"Detroit-Warren-Dearborn, MI",Metropolitan Statistical Area,"Detroit-Warren-Dearborn, MI Metro Area",4291281,4304136,8168,512175,423334,88841,114086,-194937,-80851,-0.045426295784405636,0.026585534715624543
98,"Dothan, AL",Metropolitan Statistical Area,"Dothan, AL Metro Area",145871,150214,4573,18277,17180,1097,337,3242,3579,0.02222511671271192,0.0023102604355903504
99,"Dover, DE",Metropolitan Statistical Area,"Dover, DE Metro Area",162972,183643,21291,22616,16251,6365,2840,12086,14926,0.07415997840119776,0.017426306359374616
100,"Dubuque, IA",Metropolitan Statistical Area,"Dubuque, IA Metro Area",93933,97590,3947,12260,9288,2972,1142,-99,1043,-0.0010539427038421005,0.012157601694825037
101,"Duluth, MN-WI",Metropolitan Statistical Area,"Duluth, MN-WI Metro Area",290547,288648,-1987,29576,31130,-1554,1915,-2104,-189,-0.007241513421236495,0.006591016255545574
102,"Durham-Chapel Hill, NC",Metropolitan Statistical Area,"Durham-Chapel Hill, NC Metro Area",566291,652542,88337,72592,45281,27311,21571,39066,60637,0.06898573348331513,0.038091723160000784
103,"East Stroudsburg, PA",Metropolitan Statistical Area,"East Stroudsburg, PA Metro Area",169852,170154,317,14696,14849,-153,2691,-2247,444,-0.01322916421355062,0.015843204672302946
104,"Eau Claire, WI",Metropolitan Statistical Area,"Eau Claire, WI Metro Area",161658,169997,8614,19246,14431,4815,1291,2596,3887,0.016058592831780672,0.007985995125511883
105,"El Centro, CA",Metropolitan Statistical Area,"El Centro, CA Metro Area",174704,180267,5745,30275,10616,19659,1371,-15417,-14046,-0.08824640534847514,0.007847559300302226
106,"Elizabethtown-Fort Knox, KY",Metropolitan Statistical Area,"Elizabethtown-Fort Knox, KY Metro Area",149852,154356,6024,19922,13556,6366,2394,-2932,-538,-0.01956597175880202,0.01597576275258255
107,"Elkhart-Goshen, IN",Metropolitan Statistical Area,"Elkhart-Goshen, IN Metro Area",197453,206161,8592,31576,17207,14369,1221,-6923,-5702,-0.03506150830830628,0.006183750056975584
108,"Elmira, NY",Metropolitan Statistical Area,"Elmira, NY Metro Area",88895,82622,-6224,9747,9870,-123,464,-6581,-6117,-0.0740311603577254,0.00521964114967096
109,"El Paso, TX",Metropolitan Statistical Area,"El Paso, TX Metro Area",807020,846192,42082,133284,53275,80009,16790,-55068,-38278,-0.0682362271071349,0.02080493668062749
110,"Enid, OK",Metropolitan Statistical Area,"Enid, OK Metro Area",60771,60869,287,9487,7038,2449,2061,-4200,-2139,-0.06911191193167794,0.03391420249790196
111,"Erie, PA",Metropolitan Statistical Area,"Erie, PA Metro Area",280809,268426,-12160,31336,29490,1846,6147,-20161,-14014,-0.07179613189035965,0.021890324028076023
112,"Eugene-Springfield, OR",Metropolitan Statistical Area,"Eugene-Springfield, OR Metro Area",351948,382986,31281,35750,36152,-402,5562,26261,31823,0.0746161364747065,0.015803470967301992
113,"Evansville, IN-KY",Metropolitan Statistical Area,"Evansville, IN-KY Metro Area",311809,315731,4180,37630,33558,4072,2142,-1813,329,-0.00581445692715733,0.0068695900374909
114,"Fairbanks, AK",Metropolitan Statistical Area,"Fairbanks, AK Metro Area",98272,95651,-1934,16769,4930,11839,2736,-16675,-13939,-0.16968210680560078,0.027841094106154343
115,"Fargo, ND-MN",Metropolitan Statistical Area,"Fargo, ND-MN Metro Area",209465,248594,39822,33815,15409,18406,7370,13799,21169,0.06587735421192084,0.03518487575489938
116,"Farmington, NM",Metropolitan Statistical Area,"Farmington, NM Metro Area",130209,123312,-6733,17580,10400,7180,332,-14320,-13988,-0.10997703691757098,0.00254974694529564
117,"Fayetteville, NC",Metropolitan Statistical Area,"Fayetteville, NC Metro Area",490502,529252,48215,85360,39012,46348,16376,-15898,478,-0.032411692510937784,0.033386204337596995
118,"Fayetteville-Springdale-Rogers, AR",Metropolitan Statistical Area,"Fayetteville-Springdale-Rogers, AR Metro Area",442308,548634,108516,71482,35569,35913,12489,59647,72136,0.13485399314504826,0.02823598035757888
119,"Flagstaff, AZ",Metropolitan Statistical Area,"Flagstaff, AZ Metro Area",134624,142481,8046,16520,8280,8240,1828,-2041,-213,-0.015160743998098409,0.01357855954361778
120,"Flint, MI",Metropolitan Statistical Area,"Flint, MI Metro Area",424959,404794,-20996,49570,46214,3356,2077,-26679,-24602,-0.06278017408738255,0.004887530326455023
121,"Florence, SC",Metropolitan Statistical Area,"Florence, SC Metro Area",205674,204097,-1484,25559,24323,1236,910,-3466,-2556,-0.016851911277069538,0.004424477571302158
122,"Florence-Muscle Shoals, AL",Metropolitan Statistical Area,"Florence-Muscle Shoals, AL Metro Area",147265,148779,1640,15815,18705,-2890,925,3724,4649,0.025287746579295826,0.0062811937663395925
123,"Fond du Lac, WI",Metropolitan Statistical Area,"Fond du Lac, WI Metro Area",101579,102902,1276,11083,9752,1331,1196,-1215,-19,-0.011961133698894457,0.011774087163685408
124,"Fort Collins, CO",Metropolitan Statistical Area,"Fort Collins, CO Metro Area",300453,360428,60800,34394,22266,12128,4746,43379,48125,0.14437865489777102,0.015796147816796637
125,"Fort Smith, AR-OK",Metropolitan Statistical Area,"Fort Smith, AR-OK Metro Area",248393,250434,2170,32540,27362,5178,1478,-4385,-2907,-0.017653476547245694,0.005950248195400031
126,"Fort Wayne, IN",Metropolitan Statistical Area,"Fort Wayne, IN Metro Area",389307,416565,27939,57513,35665,21848,6239,135,6374,0.0003467700298222226,0.016025912711561827
127,"Fresno, CA",Metropolitan Statistical Area,"Fresno, CA Metro Area",932011,1000918,70415,156504,69429,87075,8658,-25041,-16383,-0.026867708642923743,0.009289589929732587
128,"Gadsden, AL",Metropolitan Statistical Area,"Gadsden, AL Metro Area",104440,102371,-2041,12174,14514,-2340,390,-1,389,-9.574875526618153e-06,0.0037342014553810796
129,"Gainesville, FL",Metropolitan Statistical Area,"Gainesville, FL Metro Area",305357,332317,27233,35115,26979,8136,11679,7449,19128,0.02439439737749585,0.038247035437209566
130,"Gainesville, GA",Metropolitan Statistical Area,"Gainesville, GA Metro Area",180070,206591,26826,26275,14787,11488,1284,14078,15362,0.07818070750263786,0.00713056033764647
131,"Gettysburg, PA",Metropolitan Statistical Area,"Gettysburg, PA Metro Area",101472,102742,1323,10251,10432,-181,594,984,1578,0.009697256385998108,0.005853831598864712
132,"Glens Falls, NY",Metropolitan Statistical Area,"Glens Falls, NY Metro Area",129027,124362,-4590,11850,13623,-1773,438,-3187,-2749,-0.02470025653545382,0.003394638331512009
133,"Goldsboro, NC",Metropolitan Statistical Area,"Goldsboro, NC Metro Area",122891,123967,1302,17091,12485,4606,3040,-6338,-3298,-0.05157415921426305,0.024737368887876247
134,"Grand Forks, ND-MN",Metropolitan Statistical Area,"Grand Forks, ND-MN Metro Area",98633,100381,1917,14329,8529,5800,2269,-6157,-3888,-0.06242332687842811,0.023004471120213317
135,"Grand Island, NE",Metropolitan Statistical Area,"Grand Island, NE Metro Area",72944,75325,2571,11451,7142,4309,2810,-4509,-1699,-0.06181454266286466,0.038522702347005916
136,"Grand Junction, CO",Metropolitan Statistical Area,"Grand Junction, CO Metro Area",146266,155603,8867,17901,15037,2864,159,5881,6040,0.040207567035401265,0.001087060560895902
137,"Grand Rapids-Kentwood, MI",Metropolitan Statistical Area,"Grand Rapids-Kentwood, MI Metro Area",994270,1081372,87717,138249,78829,59420,18855,9860,28715,0.009916823398070946,0.018963661782010918
138,"Grants Pass, OR",Metropolitan Statistical Area,"Grants Pass, OR Metro Area",82880,88053,5335,8533,12381,-3848,7,9175,9182,0.11070222007722008,8.445945945945946e-05
139,"Great Falls, MT",Metropolitan Statistical Area,"Great Falls, MT Metro Area",81513,81346,19,11555,8664,2891,940,-3784,-2844,-0.046422043109688026,0.011531902886656115
140,"Greeley, CO",Metropolitan Statistical Area,"Greeley, CO Metro Area",254224,333983,81147,41936,17551,24385,2635,53627,56262,0.21094389200075525,0.0103648750708037
141,"Green Bay, WI",Metropolitan Statistical Area,"Green Bay, WI Metro Area",306749,323379,17138,39816,25492,14324,3438,-383,3055,-0.0012485778274745802,0.011207860498322732
142,"Greensboro-High Point, NC",Metropolitan Statistical Area,"Greensboro-High Point, NC Metro Area",725292,776363,52420,88413,70978,17435,14720,20701,35421,0.028541608069577493,0.020295274179227125
143,"Greenville, NC",Metropolitan Statistical Area,"Greenville, NC Metro Area",168865,182924,14751,21557,12967,8590,1539,4642,6181,0.027489414621147068,0.00911378912148758
144,"Greenville-Anderson, SC",Metropolitan Statistical Area,"Greenville-Anderson, SC Metro Area",825646,932705,108682,107278,85718,21560,16940,70036,86976,0.0848257001184527,0.020517267690995898
145,"Gulfport-Biloxi, MS",Metropolitan Statistical Area,"Gulfport-Biloxi, MS Metro Area",389356,418963,30358,51709,41018,10691,5881,13824,19705,0.035504782255827566,0.015104428851744931
146,"Hagerstown-Martinsburg, MD-WV",Metropolitan Statistical Area,"Hagerstown-Martinsburg, MD-WV Metro Area",269857,291144,21991,33217,28287,4930,2208,14839,17047,0.05498838273604168,0.008182111266337356
147,"Hammond, LA",Metropolitan Statistical Area,"Hammond, LA Metro Area",121463,136765,15682,19674,12629,7045,799,7836,8635,0.06451347323876408,0.0065781349052797975
148,"Hanford-Corcoran, CA",Metropolitan Statistical Area,"Hanford-Corcoran, CA Metro Area",152342,152692,-298,23918,8594,15324,515,-16507,-15992,-0.10835488571766158,0.00338055165351643
149,"Harrisburg-Carlisle, PA",Metropolitan Statistical Area,"Harrisburg-Carlisle, PA Metro Area",550112,581943,32486,66851,54393,12458,15660,4669,20329,0.008487362573439591,0.028466930370542726
150,"Harrisonburg, VA",Metropolitan Statistical Area,"Harrisonburg, VA Metro Area",125412,135550,10324,14802,10323,4479,5105,764,5869,0.0060919210282907536,0.04070583357254489
151,"Hartford-East Hartford-Middletown, CT",Metropolitan Statistical Area,"Hartford-East Hartford-Middletown, CT Metro Area",1214080,1201483,-10951,121906,108941,12965,49914,-74021,-24107,-0.06096879942013706,0.04111261201897733
152,"Hattiesburg, MS",Metropolitan Statistical Area,"Hattiesburg, MS Metro Area",162866,169554,7138,22971,16108,6863,1595,-1391,204,-0.00854076357250746,0.0097933270295826
153,"Hickory-Lenoir-Morganton, NC",Metropolitan Statistical Area,"Hickory-Lenoir-Morganton, NC Metro Area",365582,370266,4459,38594,41234,-2640,3090,4260,7350,0.011652652482890295,0.008452276096744371
154,"Hilton Head Island-Bluffton, SC",Metropolitan Statistical Area,"Hilton Head Island-Bluffton, SC Metro Area",187792,227244,40234,24064,18166,5898,4746,29283,34029,0.1559331600920167,0.025272642072079743
155,"Hinesville, GA",Metropolitan Statistical Area,"Hinesville, GA Metro Area",77347,83175,5246,17285,4554,12731,2925,-10896,-7971,-0.14087165630211904,0.037816592757314436
156,"Homosassa Springs, FL",Metropolitan Statistical Area,"Homosassa Springs, FL Metro Area",141177,153010,11781,10688,25947,-15259,608,26447,27055,0.18733221417086351,0.004306650516727229
157,"Hot Springs, AR",Metropolitan Statistical Area,"Hot Springs, AR Metro Area",96080,99789,3786,11205,14174,-2969,176,6616,6792,0.06885928393005829,0.0018318068276436306
158,"Houma-Thibodaux, LA",Metropolitan Statistical Area,"Houma-Thibodaux, LA Metro Area",208245,207455,-725,28924,19918,9006,1782,-11450,-9668,-0.05498331292468006,0.008557228264784271
159,"Houston-The Woodlands-Sugar Land, TX",Metropolitan Statistical Area,"Houston-The Woodlands-Sugar Land, TX Metro Area",5947185,7154478,1233993,984458,397497,586961,357316,286697,644013,0.04820717700895465,0.060081534372984864
160,"Huntington-Ashland, WV-KY-OH",Metropolitan Statistical Area,"Huntington-Ashland, WV-KY-OH Metro Area",371061,354085,-16801,41276,46200,-4924,994,-12681,-11687,-0.03417497392611996,0.002678804832628597
161,"Huntsville, AL",Metropolitan Statistical Area,"Huntsville, AL Metro Area",419282,481681,64094,53293,39071,14222,5329,44539,49868,0.106226835399564,0.012709822983099679
162,"Idaho Falls, ID",Metropolitan Statistical Area,"Idaho Falls, ID Metro Area",133818,155361,22030,24600,10510,14090,497,7493,7990,0.05599396194831786,0.0037139996114125156
163,"Indianapolis-Carmel-Anderson, IN",Metropolitan Statistical Area,"Indianapolis-Carmel-Anderson, IN Metro Area",1892663,2091019,202941,271556,167634,103922,48109,51493,99602,0.027206639533820864,0.025418682565253297
164,"Iowa City, IA",Metropolitan Statistical Area,"Iowa City, IA Metro Area",153031,175732,23147,21264,9707,11557,9924,1670,11594,0.01091282158516902,0.06484960563545948
165,"Ithaca, NY",Metropolitan Statistical Area,"Ithaca, NY Metro Area",101743,101058,-523,8432,6996,1436,7057,-9079,-2022,-0.08923464022094886,0.06936103712294703
166,"Jackson, MI",Metropolitan Statistical Area,"Jackson, MI Metro Area",160109,156920,-3313,18145,17154,991,830,-5048,-4218,-0.03152852119493595,0.0051839684215128435
167,"Jackson, MS",Metropolitan Statistical Area,"Jackson, MS Metro Area",588285,589082,1966,78354,55742,22612,5075,-25846,-20771,-0.043934487535803216,0.008626771037847302
168,"Jackson, TN",Metropolitan Statistical Area,"Jackson, TN Metro Area",179767,179131,-577,22487,20870,1617,821,-2923,-2102,-0.016259936473323803,0.0045670228684908795
169,"Jacksonville, FL",Metropolitan Statistical Area,"Jacksonville, FL Metro Area",1348967,1587892,242298,186250,130026,56224,38792,146964,185756,0.1089455857704451,0.02875681910676836
170,"Jacksonville, NC",Metropolitan Statistical Area,"Jacksonville, NC Metro Area",186918,203943,26142,42537,11014,31523,7933,-14518,-6585,-0.07767042232422773,0.0424410704159043
171,"Janesville-Beloit, WI",Metropolitan Statistical Area,"Janesville-Beloit, WI Metro Area",160261,163084,2757,19706,15320,4386,444,-1981,-1537,-0.012361085978497577,0.0027704806534340856
172,"Jefferson City, MO",Metropolitan Statistical Area,"Jefferson City, MO Metro Area",149994,150198,376,18059,13623,4436,1163,-5162,-3999,-0.0344147099217302,0.007753643479072495
173,"Johnson City, TN",Metropolitan Statistical Area,"Johnson City, TN Metro Area",199019,204540,5783,20146,24484,-4338,1771,8421,10192,0.04231254302353042,0.008898647867791517
174,"Johnstown, PA",Metropolitan Statistical Area,"Johnstown, PA Metro Area",143458,128672,-15021,13450,18963,-5513,473,-10027,-9554,-0.06989502153940526,0.003297132261707259
175,"Jonesboro, AR",Metropolitan Statistical Area,"Jonesboro, AR Metro Area",121261,135528,14515,18269,13033,5236,1529,7740,9269,0.06382926085056201,0.01260916535407097
176,"Joplin, MO",Metropolitan Statistical Area,"Joplin, MO Metro Area",175834,180099,4590,24351,18777,5574,1403,-2303,-900,-0.013097580672679916,0.00797911666685624
177,"Kahului-Wailuku-Lahaina, HI",Metropolitan Statistical Area,"Kahului-Wailuku-Lahaina, HI Metro Area",155025,167902,13062,19797,12199,7598,6714,-1183,5531,-0.0076310272536687625,0.043309143686502176
178,"Kalamazoo-Portage, MI",Metropolitan Statistical Area,"Kalamazoo-Portage, MI Metro Area",250754,265988,15661,31878,21796,10082,5213,531,5744,0.002117613278352489,0.02078929947279006
179,"Kankakee, IL",Metropolitan Statistical Area,"Kankakee, IL Metro Area",113420,108594,-4856,13470,11623,1847,488,-7210,-6722,-0.0635690354434844,0.004302592135425851
180,"Kansas City, MO-KS",Metropolitan Statistical Area,"Kansas City, MO-KS Metro Area",2013423,2173212,163859,280570,174930,105640,31882,27498,59380,0.01365733877083951,0.015834725241541395
181,"Kennewick-Richland, WA",Metropolitan Statistical Area,"Kennewick-Richland, WA Metro Area",255543,303501,50173,43316,18226,25090,4174,20825,24999,0.08149313422789903,0.016333845967214912
182,"Killeen-Temple, TX",Metropolitan Statistical Area,"Killeen-Temple, TX Metro Area",408299,468453,63126,75689,28598,47091,14464,1111,15575,0.0027210451164465252,0.03542501940979527
183,"Kingsport-Bristol, TN-VA",Metropolitan Statistical Area,"Kingsport-Bristol, TN-VA Metro Area",309488,308183,-1310,29822,40290,-10468,467,8928,9395,0.028847645142945768,0.0015089438039600886
184,"Kingston, NY",Metropolitan Statistical Area,"Kingston, NY Metro Area",182422,177716,-4806,16083,17416,-1333,2613,-6042,-3429,-0.03312100514192367,0.014323930227713763
185,"Knoxville, TN",Metropolitan Statistical Area,"Knoxville, TN Metro Area",816021,878124,63089,93371,93337,34,7594,55647,63241,0.06819309797174337,0.009306133052948392
186,"Kokomo, IN",Metropolitan Statistical Area,"Kokomo, IN Metro Area",82753,82732,-16,10165,10109,56,546,-560,-14,-0.0067671262673256564,0.006597948110642514
187,"La Crosse-Onalaska, WI-MN",Metropolitan Statistical Area,"La Crosse-Onalaska, WI-MN Metro Area",133906,137134,3474,14526,12051,2475,613,431,1044,0.0032186757874927193,0.004577838184995444
188,"Lafayette, LA",Metropolitan Statistical Area,"Lafayette, LA Metro Area",467617,489759,23027,68551,43314,25237,5014,-7176,-2162,-0.015345892044130132,0.010722450210321696
189,"Lafayette-West Lafayette, IN",Metropolitan Statistical Area,"Lafayette-West Lafayette, IN Metro Area",210689,233278,22970,27196,15774,11422,16154,-4561,11593,-0.021648021491392527,0.07667225151763975
190,"Lake Charles, LA",Metropolitan Statistical Area,"Lake Charles, LA Metro Area",199938,210313,10678,29944,21056,8888,1701,226,1927,0.0011303504086266742,0.008507637367583951
191,"Lake Havasu City-Kingman, AZ",Metropolitan Statistical Area,"Lake Havasu City-Kingman, AZ Metro Area",200336,217206,17025,18687,30248,-11561,-596,29164,28568,0.14557543327210287,-0.0029750019966456355
192,"Lakeland-Winter Haven, FL",Metropolitan Statistical Area,"Lakeland-Winter Haven, FL Metro Area",603119,744552,142484,77998,68161,9837,24844,107693,132537,0.1785601183182755,0.04119253414334485
193,"Lancaster, PA",Metropolitan Statistical Area,"Lancaster, PA Metro Area",520325,546192,26749,72008,50889,21119,12129,-6073,6056,-0.011671551434199779,0.023310430980637103
194,"Lansing-East Lansing, MI",Metropolitan Statistical Area,"Lansing-East Lansing, MI Metro Area",534902,548248,13561,60285,45675,14610,19545,-20631,-1086,-0.03856968192304384,0.03653940347951588
195,"Laredo, TX",Metropolitan Statistical Area,"Laredo, TX Metro Area",251358,277681,27377,53126,13615,39511,7248,-19382,-12134,-0.07710914313449344,0.02883536629031103
196,"Las Cruces, NM",Metropolitan Statistical Area,"Las Cruces, NM Metro Area",210096,221262,12050,29575,15857,13718,2984,-4693,-1709,-0.022337407661259613,0.014203030995354504
197,"Las Vegas-Henderson-Paradise, NV",Metropolitan Statistical Area,"Las Vegas-Henderson-Paradise, NV Metro Area",1952640,2315963,364685,274679,161068,113611,35102,214942,250044,0.11007763847918717,0.017976687971156997
198,"Lawrence, KS",Metropolitan Statistical Area,"Lawrence, KS Metro Area",111204,122530,11704,12245,7120,5125,5493,1112,6605,0.009999640300708608,0.049395705190460784
199,"Lawton, OK",Metropolitan Statistical Area,"Lawton, OK Metro Area",131568,126775,-3504,19596,11464,8132,3238,-15106,-11868,-0.11481515262069805,0.024610847622522195
200,"Lebanon, PA",Metropolitan Statistical Area,"Lebanon, PA Metro Area",133667,141663,8067,16592,15185,1407,4961,1821,6782,0.013623407422924132,0.03711462066179386
201,"Lewiston, ID-WA",Metropolitan Statistical Area,"Lewiston, ID-WA Metro Area",61042,63575,2682,7242,7696,-454,50,3117,3167,0.05106320238524295,0.0008191081550407915
202,"Lewiston-Auburn, ME",Metropolitan Statistical Area,"Lewiston-Auburn, ME Metro Area",107712,108547,834,13026,11262,1764,1566,-2456,-890,-0.02280154486036839,0.014538770053475937
203,"Lexington-Fayette, KY",Metropolitan Statistical Area,"Lexington-Fayette, KY Metro Area",473425,520391,48296,63960,41005,22955,13029,12380,25409,0.02614986534297935,0.027520726619844747
204,"Lima, OH",Metropolitan Statistical Area,"Lima, OH Metro Area",106342,101980,-4315,12966,11420,1546,366,-6231,-5865,-0.058593970397397076,0.003441725752759963
205,"Lincoln, NE",Metropolitan Statistical Area,"Lincoln, NE Metro Area",302975,337836,35679,42896,23411,19485,8974,7314,16288,0.024140605660533047,0.029619605578017988
206,"Little Rock-North Little Rock-Conway, AR",Metropolitan Statistical Area,"Little Rock-North Little Rock-Conway, AR Metro Area",702326,746564,46783,97615,67985,29630,9041,8247,17288,0.0117424102197555,0.012872939347254694
207,"Logan, UT-ID",Metropolitan Statistical Area,"Logan, UT-ID Metro Area",126170,144219,18777,25535,6545,18990,2631,-2870,-239,-0.02274708726321629,0.02085281762701117
208,"Longview, TX",Metropolitan Statistical Area,"Longview, TX Metro Area",280493,287105,7100,37825,30231,7594,2272,-2688,-416,-0.009583126851650487,0.008100023886514101
209,"Longview, WA",Metropolitan Statistical Area,"Longview, WA Metro Area",102358,111371,8963,12585,11610,975,241,7775,8016,0.07595888938822562,0.0023544813302331037
210,"Los Angeles-Long Beach-Anaheim, CA",Metropolitan Statistical Area,"Los Angeles-Long Beach-Anaheim, CA Metro Area",12838023,13109903,280999,1638228,839477,798751,358944,-871780,-512836,-0.06790609426389094,0.027959445157560475
211,"Louisville/Jefferson County, KY-IN",Metropolitan Statistical Area,"Louisville/Jefferson County, KY-IN Metro Area",1204684,1268993,66307,156220,123786,32434,23069,11529,34598,0.009570144535828485,0.01914942009688848
212,"Lubbock, TX",Metropolitan Statistical Area,"Lubbock, TX Metro Area",292269,326364,35447,42873,26128,16745,4024,14598,18622,0.04994713773954816,0.013768138256195493
213,"Lynchburg, VA",Metropolitan Statistical Area,"Lynchburg, VA Metro Area",252975,264386,11732,29107,27473,1634,4395,5799,10194,0.02292321375630003,0.017373258227097538
214,"Macon-Bibb County, GA",Metropolitan Statistical Area,"Macon-Bibb County, GA Metro Area",232199,229900,-2341,29846,25072,4774,1903,-9010,-7107,-0.03880292335453641,0.008195556397745038
215,"Madera, CA",Metropolitan Statistical Area,"Madera, CA Metro Area",151006,157761,6927,22963,11118,11845,-1062,-3930,-4992,-0.026025455942147998,-0.007032833132458313
216,"Madison, WI",Metropolitan Statistical Area,"Madison, WI Metro Area",606653,670447,64970,74439,44309,30130,17853,17068,34921,0.028134699737741343,0.0294286849319133
217,"Manchester-Nashua, NH",Metropolitan Statistical Area,"Manchester-Nashua, NH Metro Area",401064,418735,18029,43670,33432,10238,15626,-7656,7970,-0.01908922266770391,0.03896136277501845
218,"Manhattan, KS",Metropolitan Statistical Area,"Manhattan, KS Metro Area",128527,130142,3048,24171,7532,16639,8276,-22355,-14079,-0.1739323255035907,0.06439113960490793
219,"Mankato, MN",Metropolitan Statistical Area,"Mankato, MN Metro Area",96849,102723,5981,11387,7357,4030,1698,273,1971,0.002818821051327324,0.017532447418145775
220,"Mansfield, OH",Metropolitan Statistical Area,"Mansfield, OH Metro Area",124156,120891,-3581,14214,14524,-310,365,-3612,-3247,-0.029092432101549662,0.0029398498662972393
221,"McAllen-Edinburg-Mission, TX",Metropolitan Statistical Area,"McAllen-Edinburg-Mission, TX Metro Area",779091,875200,100466,157532,42913,114619,10261,-24274,-14013,-0.031156822502121064,0.013170476876257074
222,"Medford, OR",Metropolitan Statistical Area,"Medford, OR Metro Area",203357,221844,18638,23394,23882,-488,156,18974,19130,0.09330389413691194,0.0007671238265710056
223,"Memphis, TN-MS-AR",Metropolitan Statistical Area,"Memphis, TN-MS-AR Metro Area",1317533,1348678,32570,188746,120188,68558,14567,-50700,-36133,-0.03848100958382067,0.011056269558333644
224,"Merced, CA",Metropolitan Statistical Area,"Merced, CA Metro Area",256709,279252,23455,42237,17487,24750,-207,-1044,-1251,-0.00406686169943399,-0.0008063605093705324
225,"Miami-Fort Lauderdale-Pompano Beach, FL",Metropolitan Statistical Area,"Miami-Fort Lauderdale-Pompano Beach, FL Metro Area",5583460,6173008,606723,693271,503171,190100,655621,-238226,417395,-0.04266637532999251,0.11742199281449135
226,"Michigan City-La Porte, IN",Metropolitan Statistical Area,"Michigan City-La Porte, IN Metro Area",111458,109663,-1803,13352,12298,1054,295,-3092,-2797,-0.02774139137612374,0.00264673688743742
227,"Midland, MI",Metropolitan Statistical Area,"Midland, MI Metro Area",83660,83441,-182,8810,7532,1278,1340,-2795,-1455,-0.03340903657661965,0.016017212526894573
228,"Midland, TX",Metropolitan Statistical Area,"Midland, TX Metro Area",141796,183679,41993,29248,11513,17735,3720,20027,23747,0.14123811673107844,0.026234872633924797
229,"Milwaukee-Waukesha, WI",Metropolitan Statistical Area,"Milwaukee-Waukesha, WI Metro Area",1556708,1577676,21722,201811,138856,62955,29067,-69672,-40605,-0.04475598506592116,0.018672095216315455
230,"Minneapolis-St. Paul-Bloomington, MN-WI",Metropolitan Statistical Area,"Minneapolis-St. Paul-Bloomington, MN-WI Metro Area",3340070,3657477,323854,462985,238354,224631,95818,5395,101213,0.0016152356088345453,0.028687422718685532
231,"Missoula, MT",Metropolitan Statistical Area,"Missoula, MT Metro Area",109471,121630,12335,12092,8909,3183,1944,7220,9164,0.06595354020699545,0.017758127723323986
232,"Mobile, AL",Metropolitan Statistical Area,"Mobile, AL Metro Area",430955,428692,-2027,58742,46827,11915,5198,-18933,-13735,-0.043932661182722085,0.012061584156118388
233,"Modesto, CA",Metropolitan Statistical Area,"Modesto, CA Metro Area",515137,550081,35630,77693,42529,35164,4094,-3365,729,-0.0065322428790787705,0.007947400400281867
234,"Monroe, LA",Metropolitan Statistical Area,"Monroe, LA Metro Area",204681,198836,-5656,28863,22586,6277,1032,-12879,-11847,-0.06292230348688936,0.005041992173186569
235,"Monroe, MI",Metropolitan Statistical Area,"Monroe, MI Metro Area",151936,150568,-1463,15571,14929,642,363,-2460,-2097,-0.01619102780117944,0.002389163858466723
236,"Montgomery, AL",Metropolitan Statistical Area,"Montgomery, AL Metro Area",375111,372583,-1945,49504,36860,12644,4886,-19536,-14650,-0.05208058414709246,0.01302547779190693
237,"Morgantown, WV",Metropolitan Statistical Area,"Morgantown, WV Metro Area",130314,140199,10496,14368,10894,3474,4612,2312,6924,0.017741762205135292,0.035391439139309665
238,"Morristown, TN",Metropolitan Statistical Area,"Morristown, TN Metro Area",136946,143982,7121,15511,16957,-1446,872,7759,8631,0.056657368597841484,0.006367473310647993
239,"Mount Vernon-Anacortes, WA",Metropolitan Statistical Area,"Mount Vernon-Anacortes, WA Metro Area",116939,130789,13897,14792,12202,2590,2040,9304,11344,0.07956284900674711,0.017444992688495708
240,"Muncie, IN",Metropolitan Statistical Area,"Muncie, IN Metro Area",117671,113454,-4220,12104,12799,-695,1433,-4951,-3518,-0.04207493775016784,0.012178021772569282
241,"Muskegon, MI",Metropolitan Statistical Area,"Muskegon, MI Metro Area",171923,173883,1681,21441,17713,3728,846,-2888,-2042,-0.016798217806808863,0.004920807570831128
242,"Myrtle Beach-Conway-North Myrtle Beach, SC-NC",Metropolitan Statistical Area,"Myrtle Beach-Conway-North Myrtle Beach, SC-NC Metro Area",378365,514488,137923,42433,48162,-5729,3661,138511,142172,0.36607772917685305,0.009675842110131751
243,"Napa, CA",Metropolitan Statistical Area,"Napa, CA Metro Area",136752,135965,-570,14281,12639,1642,1066,-3169,-2103,-0.023173335673335668,0.007795132795132795
244,"Naples-Marco Island, FL",Metropolitan Statistical Area,"Naples-Marco Island, FL Metro Area",322576,392973,71459,32959,33701,-742,22644,49432,72076,0.15324140667625613,0.07019741084271612
245,"Nashville-Davidson--Murfreesboro--Franklin, TN",Metropolitan Statistical Area,"Nashville-Davidson--Murfreesboro--Franklin, TN Metro Area",1650887,1961232,315049,241522,145319,96203,40063,177293,217356,0.10739257138738144,0.02426756040843498
246,"New Bern, NC",Metropolitan Statistical Area,"New Bern, NC Metro Area",127427,123198,-3606,17015,13862,3153,2559,-9348,-6789,-0.07335964905396815,0.020082086214067662
247,"New Haven-Milford, CT",Metropolitan Statistical Area,"New Haven-Milford, CT Metro Area",863398,851948,-10528,90367,79982,10385,34281,-55277,-20996,-0.06402261761088165,0.03970474798412783
248,"New Orleans-Metairie, LA",Metropolitan Statistical Area,"New Orleans-Metairie, LA Metro Area",1195368,1272258,82357,160988,115092,45896,25968,9452,35420,0.007907188413944492,0.0217238540767362
249,"New York-Newark-Jersey City, NY-NJ-PA",Metropolitan Statistical Area,"New York-Newark-Jersey City, NY-NJ-PA Metro Area",18923437,19124359,228074,2447587,1439793,1007794,886432,-1664516,-778084,-0.08796055388880994,0.046843076128295295
250,"Niles, MI",Metropolitan Statistical Area,"Niles, MI Metro Area",156740,153025,-3785,18137,17778,359,3440,-7561,-4121,-0.048239122113053465,0.0219471736633916
251,"North Port-Sarasota-Bradenton, FL",Metropolitan Statistical Area,"North Port-Sarasota-Bradenton, FL Metro Area",703384,854684,152378,64826,96705,-31879,18797,164339,183136,0.2336405149960761,0.026723667299796413
252,"Norwich-New London, CT",Metropolitan Statistical Area,"Norwich-New London, CT Metro Area",274019,264999,-9077,27091,25087,2004,7141,-18281,-11140,-0.06671435192450159,0.02606023669891504
253,"Ocala, FL",Metropolitan Statistical Area,"Ocala, FL Metro Area",331341,373513,42217,35199,50252,-15053,5241,52052,57293,0.1570949565553312,0.015817541445218068
254,"Ocean City, NJ",Metropolitan Statistical Area,"Ocean City, NJ Metro Area",97222,91546,-5715,8901,13502,-4601,1114,-2131,-1017,-0.02191890724321656,0.011458311904712923
255,"Odessa, TX",Metropolitan Statistical Area,"Odessa, TX Metro Area",137060,167701,30570,29210,12230,16980,2307,10857,13164,0.07921348314606741,0.016832044360134246
256,"Ogden-Clearfield, UT",Metropolitan Statistical Area,"Ogden-Clearfield, UT Metro Area",599756,691359,94197,107488,39199,68289,4486,21636,26122,0.036074670365948816,0.007479708414755334
257,"Oklahoma City, OK",Metropolitan Statistical Area,"Oklahoma City, OK Metro Area",1257804,1425375,172386,189497,119255,70242,25751,75928,101679,0.06036552594839895,0.020472983072084363
258,"Olympia-Lacey-Tumwater, WA",Metropolitan Statistical Area,"Olympia-Lacey-Tumwater, WA Metro Area",253011,294074,41814,31868,22366,9502,4822,27548,32370,0.10888064155313404,0.019058459908857718
259,"Omaha-Council Bluffs, NE-IA",Metropolitan Statistical Area,"Omaha-Council Bluffs, NE-IA Metro Area",867705,954270,88917,134977,69901,65076,17829,6434,24263,0.007414962458439216,0.02054730582398396
260,"Orlando-Kissimmee-Sanford, FL",Metropolitan Statistical Area,"Orlando-Kissimmee-Sanford, FL Metro Area",2139227,2639374,504973,288764,176710,112054,197129,194510,391639,0.090925366966666,0.09214964096844327
261,"Oshkosh-Neenah, WI",Metropolitan Statistical Area,"Oshkosh-Neenah, WI Metro Area",167144,171631,4559,19020,15218,3802,1368,-493,875,-0.0029495524816924327,0.00818455942181592
262,"Owensboro, KY",Metropolitan Statistical Area,"Owensboro, KY Metro Area",114775,119795,5044,15854,12811,3043,1216,879,2095,0.0076584622086691345,0.01059464169026356
263,"Oxnard-Thousand Oaks-Ventura, CA",Metropolitan Statistical Area,"Oxnard-Thousand Oaks-Ventura, CA Metro Area",825144,841387,17941,101757,57839,43918,5266,-30829,-25563,-0.0373619634875852,0.0063819163685368855
264,"Palm Bay-Melbourne-Titusville, FL",Metropolitan Statistical Area,"Palm Bay-Melbourne-Titusville, FL Metro Area",544000,608459,65083,53029,71908,-18879,10321,73661,83982,0.13540625,0.01897242647058824
265,"Panama City, FL",Metropolitan Statistical Area,"Panama City, FL Metro Area",169209,171322,2479,22772,19089,3683,4163,-5432,-1269,-0.032102311342777266,0.02460271025772861
266,"Parkersburg-Vienna, WV",Metropolitan Statistical Area,"Parkersburg-Vienna, WV Metro Area",92697,88643,-4021,10333,11687,-1354,15,-2597,-2582,-0.02801600914808462,0.00016181753454804363
267,"Pensacola-Ferry Pass-Brent, FL",Metropolitan Statistical Area,"Pensacola-Ferry Pass-Brent, FL Metro Area",450993,511503,62500,59040,48958,10082,7604,44668,52272,0.0990436658662108,0.01686057211531
268,"Peoria, IL",Metropolitan Statistical Area,"Peoria, IL Metro Area",416056,396781,-19472,51886,44293,7593,4173,-31203,-27030,-0.07499711577287672,0.010029899821177921
269,"Philadelphia-Camden-Wilmington, PA-NJ-DE-MD",Metropolitan Statistical Area,"Philadelphia-Camden-Wilmington, PA-NJ-DE-MD Metro Area",5971202,6107906,142032,725215,564756,160459,167866,-183032,-15166,-0.030652454899365317,0.02811259776507309
270,"Phoenix-Mesa-Chandler, AZ",Metropolitan Statistical Area,"Phoenix-Mesa-Chandler, AZ Metro Area",4204289,5059909,866772,597279,333347,263932,117651,483408,601059,0.11497972665532745,0.02798356630574159
271,"Pine Bluff, AR",Metropolitan Statistical Area,"Pine Bluff, AR Metro Area",100099,86278,-13984,11244,11080,164,384,-14664,-14280,-0.14649496997972009,0.0038362021598617366
272,"Pittsburgh, PA",Metropolitan Statistical Area,"Pittsburgh, PA Metro Area",2357121,2309246,-47045,241354,283356,-42002,32408,-35605,-3197,-0.015105291582400732,0.013748975975352984
273,"Pittsfield, MA",Metropolitan Statistical Area,"Pittsfield, MA Metro Area",131318,124571,-6703,10857,15234,-4377,2803,-5059,-2256,-0.038524802388096066,0.021345131665118262
274,"Pocatello, ID",Metropolitan Statistical Area,"Pocatello, ID Metro Area",90899,96438,5777,14014,7825,6189,1953,-2377,-424,-0.02614990263919295,0.021485384877721427
275,"Portland-South Portland, ME",Metropolitan Statistical Area,"Portland-South Portland, ME Metro Area",513925,543221,29118,50785,50799,-14,8878,20593,29471,0.04007004913168264,0.017274894196624018
276,"Portland-Vancouver-Hillsboro, OR-WA",Metropolitan Statistical Area,"Portland-Vancouver-Hillsboro, OR-WA Metro Area",2232270,2510259,284257,277919,176270,101649,51873,130219,182092,0.0583347892504043,0.02323778037602978
277,"Port St. Lucie, FL",Metropolitan Statistical Area,"Port St. Lucie, FL Metro Area",425202,499274,75166,43722,51605,-7883,9274,73564,82838,0.17300953429193655,0.0218108099209317
278,"Poughkeepsie-Newburgh-Middletown, NY",Metropolitan Statistical Area,"Poughkeepsie-Newburgh-Middletown, NY Metro Area",671172,678527,8260,77589,53312,24277,7971,-24087,-16116,-0.03588796910478983,0.011876240367595787
279,"Prescott Valley-Prescott, AZ",Metropolitan Statistical Area,"Prescott Valley-Prescott, AZ Metro Area",210990,240226,29218,18829,29931,-11102,836,39261,40097,0.18607990900042656,0.003962273093511541
280,"Providence-Warwick, RI-MA",Metropolitan Statistical Area,"Providence-Warwick, RI-MA Metro Area",1603169,1623890,22681,168454,155647,12807,50418,-39750,10668,-0.02479464111394369,0.03144896140082549
281,"Provo-Orem, UT",Metropolitan Statistical Area,"Provo-Orem, UT Metro Area",530296,663181,136296,123671,24950,98721,8413,29291,37704,0.055235189403653816,0.015864724606634784
282,"Pueblo, CO",Metropolitan Statistical Area,"Pueblo, CO Metro Area",159401,169823,10757,19008,17833,1175,443,9240,9683,0.05796701400869505,0.0027791544595077823
283,"Punta Gorda, FL",Metropolitan Statistical Area,"Punta Gorda, FL Metro Area",159897,194711,34737,10452,26195,-15743,3075,47058,50133,0.2943019568847445,0.019231130039963226
284,"Racine, WI",Metropolitan Statistical Area,"Racine, WI Metro Area",195407,195802,368,24302,18401,5901,1189,-6670,-5481,-0.034133884661245506,0.006084735961352459
285,"Raleigh-Cary, NC",Metropolitan Statistical Area,"Raleigh-Cary, NC Metro Area",1137386,1420376,289897,160247,74975,85272,38575,164583,203158,0.1447028537365503,0.033915486914732555
286,"Rapid City, SD",Metropolitan Statistical Area,"Rapid City, SD Metro Area",126731,144514,18115,18624,11071,7553,1728,8785,10513,0.06932005586636261,0.013635180026986294
287,"Reading, PA",Metropolitan Statistical Area,"Reading, PA Metro Area",412041,421017,9448,48972,39880,9092,14196,-13727,469,-0.033314645872619474,0.0344528821161001
288,"Redding, CA",Metropolitan Statistical Area,"Redding, CA Metro Area",177277,179027,1805,20960,22660,-1700,2008,1689,3697,0.009527462671412535,0.011326906479689976
289,"Reno, NV",Metropolitan Statistical Area,"Reno, NV Metro Area",425966,481289,55847,55222,39487,15735,1027,38981,40008,0.09151199861021772,0.0024109905485414328
290,"Richmond, VA",Metropolitan Statistical Area,"Richmond, VA Metro Area",1188423,1303469,116858,150233,108894,41339,32866,42783,75649,0.03599980814911862,0.0276551362604056
291,"Riverside-San Bernardino-Ontario, CA",Metropolitan Statistical Area,"Riverside-San Bernardino-Ontario, CA Metro Area",4242365,4678371,453414,616100,306646,309454,19843,125342,145185,0.029545312579186377,0.004677343887194996
292,"Roanoke, VA",Metropolitan Statistical Area,"Roanoke, VA Metro Area",308602,313784,5116,33472,36284,-2812,6427,1702,8129,0.005515194327969358,0.02082617740649769
293,"Rochester, MN",Metropolitan Statistical Area,"Rochester, MN Metro Area",207228,223062,16172,29427,16380,13047,5922,-2704,3218,-0.013048429748875635,0.028577219294689905
294,"Rochester, NY",Metropolitan Statistical Area,"Rochester, NY Metro Area",1079975,1067486,-12216,116740,100998,15742,23514,-51383,-27869,-0.047577953193360965,0.021772726220514363
295,"Rockford, IL",Metropolitan Statistical Area,"Rockford, IL Metro Area",349184,334072,-15359,42563,33589,8974,3457,-28001,-24544,-0.08018981396627567,0.009900224523460413
296,"Rocky Mount, NC",Metropolitan Statistical Area,"Rocky Mount, NC Metro Area",152414,145688,-6681,17430,17393,37,629,-7374,-6745,-0.04838138228771635,0.0041269174747726595
297,"Rome, GA",Metropolitan Statistical Area,"Rome, GA Metro Area",96436,98604,2286,12044,11091,953,1410,-20,1390,-0.00020739143058608815,0.01462109585631922
298,"Sacramento-Roseville-Folsom, CA",Metropolitan Statistical Area,"Sacramento-Roseville-Folsom, CA Metro Area",2153610,2374749,225598,278110,176733,101377,53530,71830,125360,0.033353299808228966,0.024855939561944828
299,"Saginaw, MI",Metropolitan Statistical Area,"Saginaw, MI Metro Area",199871,189868,-10301,22928,21691,1237,1859,-13486,-11627,-0.06747352042067133,0.00930099914444817
300,"St. Cloud, MN",Metropolitan Statistical Area,"St. Cloud, MN Metro Area",189233,202996,13899,26142,14015,12127,6521,-4713,1808,-0.024905803955969624,0.03446016286799871
301,"St. George, UT",Metropolitan Statistical Area,"St. George, UT Metro Area",138397,184913,46798,22746,12994,9752,269,36636,36905,0.2647167207381663,0.0019436837503703113
302,"St. Joseph, MO-KS",Metropolitan Statistical Area,"St. Joseph, MO-KS Metro Area",127274,122556,-4767,15603,13561,2042,1777,-8560,-6783,-0.06725647029243992,0.013962003237110486
303,"St. Louis, MO-IL",Metropolitan Statistical Area,"St. Louis, MO-IL Metro Area",2790104,2805473,17687,342967,272411,70556,38323,-90508,-52185,-0.03243893417593036,0.013735330295931622
304,"Salem, OR",Metropolitan Statistical Area,"Salem, OR Metro Area",391488,436948,46203,53500,35420,18080,2869,25436,28305,0.06497261729606016,0.007328449403302272
305,"Salinas, CA",Metropolitan Statistical Area,"Salinas, CA Metro Area",416358,430906,15848,64707,25951,38756,2471,-25268,-22797,-0.06068815778728881,0.005934796497245159
306,"Salisbury, MD-DE",Metropolitan Statistical Area,"Salisbury, MD-DE Metro Area",374821,423481,49730,42859,44668,-1809,6212,45102,51314,0.12032943725138133,0.016573244295276946
307,"Salt Lake City, UT",Metropolitan Statistical Area,"Salt Lake City, UT Metro Area",1091499,1240029,152221,187551,69815,117736,31686,3420,35106,0.003133305664961672,0.029029802134495776
308,"San Angelo, TX",Metropolitan Statistical Area,"San Angelo, TX Metro Area",113427,122889,9921,16216,10967,5249,808,3822,4630,0.033695680922531675,0.007123524381320144
309,"San Antonio-New Braunfels, TX",Metropolitan Statistical Area,"San Antonio-New Braunfels, TX Metro Area",2153021,2590732,448207,332108,172814,159294,46566,240407,286973,0.11166031357799112,0.02162821449488881
310,"San Diego-Chula Vista-Carlsbad, CA",Metropolitan Statistical Area,"San Diego-Chula Vista-Carlsbad, CA Metro Area",3103260,3332427,237075,436256,217725,218531,102224,-81175,21049,-0.02615797580608779,0.03294084285557768
311,"San Francisco-Oakland-Berkeley, CA",Metropolitan Statistical Area,"San Francisco-Oakland-Berkeley, CA Metro Area",4343886,4696902,361294,524805,308729,216076,232418,-86485,145933,-0.01990959247088897,0.053504626963046455
312,"San Jose-Sunnyvale-Santa Clara, CA",Metropolitan Statistical Area,"San Jose-Sunnyvale-Santa Clara, CA Metro Area",1841545,1971160,134215,242199,106077,136122,154376,-155059,-683,-0.08420049469331459,0.08382961046295366
313,"San Luis Obispo-Paso Robles, CA",Metropolitan Statistical Area,"San Luis Obispo-Paso Robles, CA Metro Area",269800,282249,12650,26424,24329,2095,733,9870,10603,0.036582653817642696,0.0027168272794662715
314,"Santa Cruz-Watsonville, CA",Metropolitan Statistical Area,"Santa Cruz-Watsonville, CA Metro Area",263174,269925,7580,29038,18157,10881,1603,-4810,-3207,-0.01827688145485496,0.006091027229133577
315,"Santa Fe, NM",Metropolitan Statistical Area,"Santa Fe, NM Metro Area",144526,151946,7709,13243,11800,1443,2680,3727,6407,0.025787747533315804,0.018543376278316703
316,"Santa Maria-Santa Barbara, CA",Metropolitan Statistical Area,"Santa Maria-Santa Barbara, CA Metro Area",424218,444766,20819,57494,31893,25601,8432,-12997,-4565,-0.03063754956178192,0.01987657289412519
317,"Santa Rosa-Petaluma, CA",Metropolitan Statistical Area,"Santa Rosa-Petaluma, CA Metro Area",484675,489819,5953,50154,42154,8000,2871,-4655,-1784,-0.00960437406509517,0.005923557022747202
318,"Savannah, GA",Metropolitan Statistical Area,"Savannah, GA Metro Area",348672,395983,48375,52104,31443,20661,7452,20133,27585,0.057741946585903085,0.02137252202643172
319,"Scranton--Wilkes-Barre, PA",Metropolitan Statistical Area,"Scranton--Wilkes-Barre, PA Metro Area",563790,552528,-11107,57727,72292,-14565,15475,-11621,3854,-0.020612284715940333,0.027448163323223185
320,"Seattle-Tacoma-Bellevue, WA",Metropolitan Statistical Area,"Seattle-Tacoma-Bellevue, WA Metro Area",3449355,4018598,578790,470764,252700,218064,214454,145788,360242,0.0422652930765317,0.06217220320900574
321,"Sebastian-Vero Beach, FL",Metropolitan Statistical Area,"Sebastian-Vero Beach, FL Metro Area",138277,162518,24490,12969,20372,-7403,2352,29438,31790,0.2128915148578578,0.0170093363321449
322,"Sebring-Avon Park, FL",Metropolitan Statistical Area,"Sebring-Avon Park, FL Metro Area",98637,106639,7853,9120,15875,-6755,3406,11278,14684,0.1143384328396038,0.03453065279763172
323,"Sheboygan, WI",Metropolitan Statistical Area,"Sheboygan, WI Metro Area",115520,115240,-269,12894,11309,1585,791,-2610,-1819,-0.02259349030470914,0.006847299168975069
324,"Sherman-Denison, TX",Metropolitan Statistical Area,"Sherman-Denison, TX Metro Area",121029,138318,17449,16034,14524,1510,1221,14769,15990,0.12202860471457255,0.010088491188062366
325,"Shreveport-Bossier City, LA",Metropolitan Statistical Area,"Shreveport-Bossier City, LA Metro Area",399959,392404,-6210,57200,41944,15256,3162,-24742,-21580,-0.06186134078743071,0.00790581034556042
326,"Sierra Vista-Douglas, AZ",Metropolitan Statistical Area,"Sierra Vista-Douglas, AZ Metro Area",131823,127450,-3909,15790,13365,2425,2745,-9309,-6564,-0.07061741881158827,0.020823376800710044
327,"Sioux City, IA-NE-SD",Metropolitan Statistical Area,"Sioux City, IA-NE-SD Metro Area",143902,144996,1420,21568,13272,8296,2700,-9635,-6935,-0.06695528901613597,0.01876276910675321
328,"Sioux Falls, SD",Metropolitan Statistical Area,"Sioux Falls, SD Metro Area",229110,273566,45298,39602,18373,21229,8321,15614,23935,0.06815066998385055,0.03631879883025621
329,"South Bend-Mishawaka, IN-MI",Metropolitan Statistical Area,"South Bend-Mishawaka, IN-MI Metro Area",319044,323068,3867,41027,32268,8759,5521,-10306,-4785,-0.03230275447900603,0.017304823159188073
330,"Spartanburg, SC",Metropolitan Statistical Area,"Spartanburg, SC Metro Area",284769,326205,41876,37858,31185,6673,2234,33031,35265,0.11599226039351193,0.007844955033729093
331,"Spokane-Spokane Valley, WA",Metropolitan Statistical Area,"Spokane-Spokane Valley, WA Metro Area",515574,574585,59833,65311,50539,14772,5949,39388,45337,0.07639640478379438,0.01153859581747722
332,"Springfield, IL",Metropolitan Statistical Area,"Springfield, IL Metro Area",210465,205950,-4218,24672,21541,3131,2421,-9696,-7275,-0.04606941771791034,0.011503100277955954
333,"Springfield, MA",Metropolitan Statistical Area,"Springfield, MA Metro Area",694951,695654,2595,69448,65819,3629,31789,-32813,-1024,-0.04721627855776882,0.045742793376799235
334,"Springfield, MO",Metropolitan Statistical Area,"Springfield, MO Metro Area",437362,475220,38464,58176,44152,14024,3600,20920,24520,0.047832230509280635,0.00823116777406359
335,"Springfield, OH",Metropolitan Statistical Area,"Springfield, OH Metro Area",138272,133593,-4746,16273,17744,-1471,664,-3867,-3203,-0.027966616523952787,0.004802129136773896
336,"State College, PA",Metropolitan Statistical Area,"State College, PA Metro Area",154242,161496,7488,12487,10114,2373,9996,-4887,5109,-0.031683977126852614,0.06480725094332282
337,"Staunton, VA",Metropolitan Statistical Area,"Staunton, VA Metro Area",118320,124475,5977,12934,13823,-889,1564,5340,6904,0.045131845841784986,0.0132183908045977
338,"Stockton, CA",Metropolitan Statistical Area,"Stockton, CA Metro Area",687115,767967,82669,103227,55216,48011,10100,24846,34946,0.036159885899740216,0.014699140609650494
339,"Sumter, SC",Metropolitan Statistical Area,"Sumter, SC Metro Area",142557,139775,-2659,18320,15333,2987,1333,-6939,-5606,-0.0486752667354111,0.00935064570662963
340,"Syracuse, NY",Metropolitan Statistical Area,"Syracuse, NY Metro Area",663132,646038,-16596,73874,61293,12581,14073,-43335,-29262,-0.06534898029351623,0.02122201914550949
341,"Tallahassee, FL",Metropolitan Statistical Area,"Tallahassee, FL Metro Area",369351,389599,20837,41172,28175,12997,7031,585,7616,0.0015838592558298206,0.019036093038870883
342,"Tampa-St. Petersburg-Clearwater, FL",Metropolitan Statistical Area,"Tampa-St. Petersburg-Clearwater, FL Metro Area",2788433,3243963,460472,325766,317478,8288,116307,334230,450537,0.1198630198394582,0.041710523437357115
343,"Terre Haute, IN",Metropolitan Statistical Area,"Terre Haute, IN Metro Area",189537,185632,-4146,22038,21382,656,1703,-6464,-4761,-0.034104159082395516,0.008985053050327905
344,"Texarkana, TX-AR",Metropolitan Statistical Area,"Texarkana, TX-AR Metro Area",149346,148838,-356,19696,16992,2704,518,-3508,-2990,-0.023489079051330467,0.003468455800624054
345,"The Villages, FL",Metropolitan Statistical Area,"The Villages, FL Metro Area",94286,139018,45598,4768,17198,-12430,244,57205,57449,0.606717858430732,0.002587870945845619
346,"Toledo, OH",Metropolitan Statistical Area,"Toledo, OH Metro Area",651392,641549,-9885,79105,66802,12303,7093,-29386,-22293,-0.045112620357634116,0.010888988504617805
347,"Topeka, KS",Metropolitan Statistical Area,"Topeka, KS Metro Area",234267,230878,-2982,29495,24756,4739,1704,-9357,-7653,-0.03994160509162622,0.007273751744804006
348,"Trenton-Princeton, NJ",Metropolitan Statistical Area,"Trenton-Princeton, NJ Metro Area",367717,367239,-246,42239,30039,12200,18281,-30869,-12588,-0.08394770978768999,0.04971486224460658
349,"Tucson, AZ",Metropolitan Statistical Area,"Tucson, AZ Metro Area",981649,1061175,80909,117433,96509,20924,25365,35533,60898,0.03619725584195573,0.025839174694824732
350,"Tulsa, OK",Metropolitan Statistical Area,"Tulsa, OK Metro Area",939868,1006411,68890,134138,96686,37452,15256,16587,31843,0.017648222941945037,0.016232066630633236
351,"Tuscaloosa, AL",Metropolitan Statistical Area,"Tuscaloosa, AL Metro Area",239492,253211,13986,30423,23456,6967,3102,3834,6936,0.016008885474253838,0.012952415947088005
352,"Twin Falls, ID",Metropolitan Statistical Area,"Twin Falls, ID Metro Area",99985,112989,13394,16277,9341,6936,2829,3658,6487,0.036585487823173474,0.02829424413662049
353,"Tyler, TX",Metropolitan Statistical Area,"Tyler, TX Metro Area",210407,235806,26077,31078,21241,9837,2161,14129,16290,0.06715080772027547,0.010270570846026986
354,"Urban Honolulu, HI",Metropolitan Statistical Area,"Urban Honolulu, HI Metro Area",956320,963826,10623,133124,79117,54007,46120,-88836,-42716,-0.09289359210306174,0.04822653505102895
355,"Utica-Rome, NY",Metropolitan Statistical Area,"Utica-Rome, NY Metro Area",299222,288291,-11029,32683,33117,-434,5492,-16069,-10577,-0.053702602081397766,0.018354265394924168
356,"Valdosta, GA",Metropolitan Statistical Area,"Valdosta, GA Metro Area",140067,148364,8694,20669,12305,8364,2286,-2159,127,-0.015414051846616263,0.01632076077877016
357,"Vallejo, CA",Metropolitan Statistical Area,"Vallejo, CA Metro Area",413963,446935,33592,52637,33374,19263,6737,7856,14593,0.018977541471097658,0.016274401335385047
358,"Victoria, TX",Metropolitan Statistical Area,"Victoria, TX Metro Area",94102,99562,5557,13691,9054,4637,543,359,902,0.003815009245287029,0.005770334318080381
359,"Vineland-Bridgeton, NJ",Metropolitan Statistical Area,"Vineland-Bridgeton, NJ Metro Area",156667,147008,-9602,20374,15718,4656,3040,-17382,-14342,-0.1109487001091487,0.019404214033587164
360,"Virginia Beach-Norfolk-Newport News, VA-NC",Metropolitan Statistical Area,"Virginia Beach-Norfolk-Newport News, VA-NC Metro Area",1717110,1779824,65869,231756,147831,83925,43388,-61337,-17949,-0.03572106621008555,0.025268037574762245
361,"Visalia, CA",Metropolitan Statistical Area,"Visalia, CA Metro Area",442953,468680,26504,75989,30822,45167,-1311,-17347,-18658,-0.03916216844676523,-0.0029596819527128162
362,"Waco, TX",Metropolitan Statistical Area,"Waco, TX Metro Area",253799,277005,24244,37638,23648,13990,2835,7521,10356,0.029633686499946812,0.011170256778001491
363,"Walla Walla, WA",Metropolitan Statistical Area,"Walla Walla, WA Metro Area",58915,61292,2511,6711,5870,841,562,1130,1692,0.01918017482814224,0.009539166595943309
364,"Warner Robins, GA",Metropolitan Statistical Area,"Warner Robins, GA Metro Area",168518,188060,20433,23900,14460,9440,2441,8580,11021,0.0509144423741084,0.014485099514591912
365,"Washington-Arlington-Alexandria, DC-VA-MD-WV",Metropolitan Statistical Area,"Washington-Arlington-Alexandria, DC-VA-MD-WV Metro Area",5678733,6324629,674931,820653,356952,463701,366096,-156947,209149,-0.027637679038616532,0.06446790155480105
366,"Waterloo-Cedar Falls, IA",Metropolitan Statistical Area,"Waterloo-Cedar Falls, IA Metro Area",167924,168314,495,21342,16121,5221,3427,-8048,-4621,-0.04792644291465187,0.020408041733165003
367,"Watertown-Fort Drum, NY",Metropolitan Statistical Area,"Watertown-Fort Drum, NY Metro Area",116609,108095,-8139,20811,9304,11507,3600,-23363,-19763,-0.2003533174969342,0.030872402644735824
368,"Wausau-Weston, WI",Metropolitan Statistical Area,"Wausau-Weston, WI Metro Area",162841,163159,343,18987,15524,3463,719,-3763,-3044,-0.02310843092341609,0.004415349942582028
369,"Weirton-Steubenville, WV-OH",Metropolitan Statistical Area,"Weirton-Steubenville, WV-OH Metro Area",124328,115184,-9271,11466,17438,-5972,16,-3203,-3187,-0.025762499195675952,0.000128691847371469
370,"Wenatchee, WA",Metropolitan Statistical Area,"Wenatchee, WA Metro Area",111260,121134,10247,14710,10244,4466,628,5223,5851,0.046944094912816835,0.005644436455150099
371,"Wheeling, WV-OH",Metropolitan Statistical Area,"Wheeling, WV-OH Metro Area",147905,137217,-10746,14630,19354,-4724,204,-6118,-5914,-0.0413643893039451,0.0013792637165748285
372,"Wichita, KS",Metropolitan Statistical Area,"Wichita, KS Metro Area",623898,643768,20707,89475,58245,31230,9997,-20341,-10344,-0.032603085760813465,0.016023452551538874
373,"Wichita Falls, TX",Metropolitan Statistical Area,"Wichita Falls, TX Metro Area",151657,152485,1011,19184,16095,3089,3625,-5673,-2048,-0.037406779772776726,0.02390262236494194
374,"Williamsport, PA",Metropolitan Statistical Area,"Williamsport, PA Metro Area",116215,113209,-2886,12652,13133,-481,869,-3242,-2373,-0.027896571010626856,0.007477520113582584
375,"Wilmington, NC",Metropolitan Statistical Area,"Wilmington, NC Metro Area",255710,301284,46406,29169,24939,4230,1749,40021,41770,0.15650932697196046,0.006839779437644206
376,"Winchester, VA-WV",Metropolitan Statistical Area,"Winchester, VA-WV Metro Area",128640,142009,13568,15900,12456,3444,2194,7962,10156,0.06189365671641791,0.017055348258706467
377,"Winston-Salem, NC",Metropolitan Statistical Area,"Winston-Salem, NC Metro Area",641236,679731,39242,75790,66442,9348,5879,24345,30224,0.03796574116238016,0.009168231353199134
378,"Worcester, MA-CT",Metropolitan Statistical Area,"Worcester, MA-CT Metro Area",918947,945752,28988,99345,83112,16233,38411,-25321,13090,-0.02755436385341048,0.041798928556271465
379,"Yakima, WA",Metropolitan Statistical Area,"Yakima, WA Metro Area",244249,251879,8639,40578,20133,20445,848,-12673,-11825,-0.051885575785366574,0.003471866824429169
380,"York-Hanover, PA",Metropolitan Statistical Area,"York-Hanover, PA Metro Area",435420,450448,15432,49895,41514,8381,6139,1319,7458,0.0030292591061503835,0.01409903082081668
381,"Youngstown-Warren-Boardman, OH-PA",Metropolitan Statistical Area,"Youngstown-Warren-Boardman, OH-PA Metro Area",564760,531420,-34362,57343,72228,-14885,3251,-22529,-19278,-0.039891281252213334,0.005756427509030384
382,"Yuba City, CA",Metropolitan Statistical Area,"Yuba City, CA Metro Area",167087,176545,9652,25448,14413,11035,2645,-4035,-1390,-0.024149095979938598,0.015830076546948596
383,"Yuma, AZ",Metropolitan Statistical Area,"Yuma, AZ Metro Area",197148,217824,22074,31510,15302,16208,7840,-2219,5621,-0.011255503479619372,0.039767078539980114
384,"Aberdeen, SD",Micropolitan Statistical Area,"Aberdeen, SD Micro Area",40721,42555,1952,5556,4224,1332,1211,-594,617,-0.01458706809754181,0.029738955330173625
385,"Aberdeen, WA",Micropolitan Statistical Area,"Aberdeen, WA Micro Area",72849,75950,3150,7903,8666,-763,85,3833,3918,0.05261568449807135,0.0011667970733983994
386,"Ada, OK",Micropolitan Statistical Area,"Ada, OK Micro Area",37594,38397,909,5427,4600,827,379,-274,105,-0.007288397084641166,0.010081395967441613
387,"Adrian, MI",Micropolitan Statistical Area,"Adrian, MI Micro Area",99642,97808,-2090,10573,10449,124,577,-2785,-2208,-0.02795006121916461,0.005790730816322434
388,"Alamogordo, NM",Micropolitan Statistical Area,"Alamogordo, NM Micro Area",64405,67967,4131,9249,6127,3122,4099,-3174,925,-0.04928188805216986,0.06364412700877263
389,"Albemarle, NC",Micropolitan Statistical Area,"Albemarle, NC Micro Area",60578,63239,2654,6919,7159,-240,179,2770,2949,0.0457261712172736,0.00295486810393212
390,"Albert Lea, MN",Micropolitan Statistical Area,"Albert Lea, MN Micro Area",31203,30364,-890,3424,3728,-304,270,-843,-573,-0.027016633016056148,0.008653014133256417
391,"Albertville, AL",Micropolitan Statistical Area,"Albertville, AL Micro Area",93119,96990,3973,13688,11537,2151,858,1050,1908,0.011275894285806332,0.009214016473544605
392,"Alexander City, AL",Micropolitan Statistical Area,"Alexander City, AL Micro Area",53259,50783,-2594,5458,6969,-1511,75,-1147,-1072,-0.0215362661709758,0.0014082126964456714
393,"Alexandria, MN",Micropolitan Statistical Area,"Alexandria, MN Micro Area",35990,38328,2317,4256,4271,-15,104,2259,2363,0.06276743539872187,0.0028896915809947213
394,"Alice, TX",Micropolitan Statistical Area,"Alice, TX Micro Area",52619,51510,-1115,7879,5482,2397,467,-4002,-3535,-0.07605617742640491,0.008875121153955796
395,"Alma, MI",Micropolitan Statistical Area,"Alma, MI Micro Area",42431,40283,-2195,4134,4588,-454,115,-1862,-1747,-0.04388301006339705,0.002710282576418185
396,"Alpena, MI",Micropolitan Statistical Area,"Alpena, MI Micro Area",29511,28238,-1356,2688,3823,-1135,75,-270,-195,-0.009149130832570906,0.002541425231269696
397,"Altus, OK",Micropolitan Statistical Area,"Altus, OK Micro Area",26485,24305,-2141,4185,2621,1564,643,-4386,-3743,-0.16560317160656976,0.024277893147064376
398,"Americus, GA",Micropolitan Statistical Area,"Americus, GA Micro Area",37628,34478,-3277,4478,4036,442,291,-4054,-3763,-0.10773891782715,0.007733602636334646
399,"Amsterdam, NY",Micropolitan Statistical Area,"Amsterdam, NY Micro Area",50312,49170,-1098,6158,5960,198,1181,-2466,-1285,-0.049014151693432984,0.02347352520273493
400,"Andrews, TX",Micropolitan Statistical Area,"Andrews, TX Micro Area",14849,18879,4093,3185,1379,1806,223,2015,2238,0.13569937369519833,0.015017846319617485
401,"Angola, IN",Micropolitan Statistical Area,"Angola, IN Micro Area",34110,34831,684,3881,3286,595,172,-51,121,-0.0014951627088830256,0.005042509527997655
402,"Arcadia, FL",Micropolitan Statistical Area,"Arcadia, FL Micro Area",34935,38520,3658,3958,3358,600,1440,1632,3072,0.04671532846715328,0.041219407471017606
403,"Ardmore, OK",Micropolitan Statistical Area,"Ardmore, OK Micro Area",57221,58583,1438,8029,7559,470,508,488,996,0.008528337498470841,0.008877859527096695
404,"Arkadelphia, AR",Micropolitan Statistical Area,"Arkadelphia, AR Micro Area",22928,22103,-889,2412,2571,-159,203,-938,-735,-0.040910676901605034,0.008853803210048848
405,"Ashland, OH",Micropolitan Statistical Area,"Ashland, OH Micro Area",53317,53362,226,6248,5811,437,868,-1070,-202,-0.020068646022844496,0.0162799857456346
406,"Ashtabula, OH",Micropolitan Statistical Area,"Ashtabula, OH Micro Area",101411,96513,-4984,11394,12204,-810,636,-4810,-4174,-0.04743075208803778,0.0062715090078985505
407,"Astoria, OR",Micropolitan Statistical Area,"Astoria, OR Micro Area",37097,40423,3389,4161,4063,98,232,3055,3287,0.08235167264199261,0.006253874976413187
408,"Atchison, KS",Micropolitan Statistical Area,"Atchison, KS Micro Area",16855,16015,-906,2017,1855,162,13,-1088,-1075,-0.06455057846336397,0.00077128448531593
409,"Athens, OH",Micropolitan Statistical Area,"Athens, OH Micro Area",65175,65481,718,5382,5037,345,2610,-2347,263,-0.036010740314537784,0.04004602991944764
410,"Athens, TN",Micropolitan Statistical Area,"Athens, TN Micro Area",52173,54208,1925,5877,6929,-1052,512,2504,3016,0.04799417323136488,0.009813505069672051
411,"Athens, TX",Micropolitan Statistical Area,"Athens, TX Micro Area",78652,83792,5225,9226,10909,-1683,279,6672,6951,0.08482937496821441,0.0035472715251996132
412,"Atmore, AL",Micropolitan Statistical Area,"Atmore, AL Micro Area",38352,36281,-2044,4551,4842,-291,24,-1764,-1740,-0.04599499374217772,0.0006257822277847308
413,"Auburn, IN",Micropolitan Statistical Area,"Auburn, IN Micro Area",42335,43670,1415,5447,4219,1228,-2,212,210,0.005007676863115625,-4.724223455769458e-05
414,"Auburn, NY",Micropolitan Statistical Area,"Auburn, NY Micro Area",79905,76029,-3993,7805,7844,-39,511,-4462,-3951,-0.0558413115574745,0.006395094174332019
415,"Augusta-Waterville, ME",Micropolitan Statistical Area,"Augusta-Waterville, ME Micro Area",122074,122955,804,12047,13701,-1654,705,1851,2556,0.015162933958090994,0.005775185543195111
416,"Austin, MN",Micropolitan Statistical Area,"Austin, MN Micro Area",39209,40150,985,5273,4056,1217,1298,-1510,-212,-0.038511566222040855,0.033104644341860286
417,"Bainbridge, GA",Micropolitan Statistical Area,"Bainbridge, GA Micro Area",27815,26457,-1384,3753,3254,499,-33,-1859,-1892,-0.06683444184792378,-0.0011864102103181734
418,"Baraboo, WI",Micropolitan Statistical Area,"Baraboo, WI Micro Area",62051,64449,2494,7786,6333,1453,576,525,1101,0.008460782259754072,0.009282686822130185
419,"Bardstown, KY",Micropolitan Statistical Area,"Bardstown, KY Micro Area",43626,46450,3009,5882,4127,1755,-7,1281,1274,0.029363223765644337,-0.00016045477467565214
420,"Barre, VT",Micropolitan Statistical Area,"Barre, VT Micro Area",59573,58328,-1197,5671,5567,104,178,-1456,-1278,-0.024440602286270628,0.0029879307740083593
421,"Bartlesville, OK",Micropolitan Statistical Area,"Bartlesville, OK Micro Area",51071,52222,1243,6402,6440,-38,1020,306,1326,0.005991658671261577,0.019972195570871924
422,"Batavia, NY",Micropolitan Statistical Area,"Batavia, NY Micro Area",59932,56994,-2943,6066,6427,-361,255,-2842,-2587,-0.0474204097977708,0.004254822131749316
423,"Batesville, AR",Micropolitan Statistical Area,"Batesville, AR Micro Area",54055,55181,1280,6560,7042,-482,248,1536,1784,0.02841550272870225,0.00458791971140505
424,"Bay City, TX",Micropolitan Statistical Area,"Bay City, TX Micro Area",36706,36725,23,5455,3882,1573,199,-1746,-1547,-0.04756715523347682,0.0054214569825096716
425,"Beatrice, NE",Micropolitan Statistical Area,"Beatrice, NE Micro Area",22269,21431,-880,2401,2833,-432,49,-493,-444,-0.02213839867079797,0.002200368224886613
426,"Beaver Dam, WI",Micropolitan Statistical Area,"Beaver Dam, WI Micro Area",88723,87336,-1408,8340,9332,-992,259,-617,-358,-0.006954228328618284,0.0029191979531801226
427,"Bedford, IN",Micropolitan Statistical Area,"Bedford, IN Micro Area",46105,45496,-638,5051,5714,-663,86,-16,70,-0.0003470339442576727,0.0018653074503849907
428,"Beeville, TX",Micropolitan Statistical Area,"Beeville, TX Micro Area",31862,32513,655,3686,2591,1095,61,-499,-438,-0.015661289310150022,0.0019145063084552128
429,"Bellefontaine, OH",Micropolitan Statistical Area,"Bellefontaine, OH Micro Area",45743,45326,-522,5582,5064,518,143,-1160,-1017,-0.02535907133331876,0.003126161379883261
430,"Bemidji, MN",Micropolitan Statistical Area,"Bemidji, MN Micro Area",44572,47442,3000,6997,4170,2827,388,-191,197,-0.0042852014717760034,0.008705016602351252
431,"Bennettsville, SC",Micropolitan Statistical Area,"Bennettsville, SC Micro Area",28918,25581,-3354,3025,3571,-546,72,-2886,-2814,-0.0997994328791756,0.002489798741268414
432,"Bennington, VT",Micropolitan Statistical Area,"Bennington, VT Micro Area",37078,35338,-1781,3371,4641,-1270,363,-855,-492,-0.02305949619720589,0.00979017206969092
433,"Berlin, NH",Micropolitan Statistical Area,"Berlin, NH Micro Area",32970,31174,-1878,2524,4491,-1967,91,-56,35,-0.0016985138004246285,0.002760084925690021
434,"Big Rapids, MI",Micropolitan Statistical Area,"Big Rapids, MI Micro Area",42851,43907,1111,4305,3956,349,475,304,779,0.0070943501901939285,0.011084922172178012
435,"Big Spring, TX",Micropolitan Statistical Area,"Big Spring, TX Micro Area",34983,36540,1534,4681,3915,766,872,-134,738,-0.0038304319240774092,0.024926392819369408
436,"Big Stone Gap, VA",Micropolitan Statistical Area,"Big Stone Gap, VA Micro Area",45587,41191,-4239,4599,5478,-879,176,-3576,-3400,-0.07844341588610787,0.0038607497751551975
437,"Blackfoot, ID",Micropolitan Statistical Area,"Blackfoot, ID Micro Area",45764,47202,1597,7045,3709,3336,148,-1925,-1777,-0.04206363080150337,0.0032339830434402585
438,"Bluefield, WV-VA",Micropolitan Statistical Area,"Bluefield, WV-VA Micro Area",114254,105026,-9123,12132,16252,-4120,275,-5229,-4954,-0.045766450189927706,0.002406917919722723
439,"Bluffton, IN",Micropolitan Statistical Area,"Bluffton, IN Micro Area",27680,28142,505,3509,2925,584,175,-241,-66,-0.008706647398843931,0.006322254335260116
440,"Blytheville, AR",Micropolitan Statistical Area,"Blytheville, AR Micro Area",46350,40066,-6414,6474,5312,1162,65,-7709,-7644,-0.16632146709816611,0.0014023732470334412
441,"Bogalusa, LA",Micropolitan Statistical Area,"Bogalusa, LA Micro Area",47083,45773,-1361,5891,6086,-195,-42,-1101,-1143,-0.023384236348575917,-0.0008920417135696537
442,"Bonham, TX",Micropolitan Statistical Area,"Bonham, TX Micro Area",33922,35913,2001,3396,4390,-994,397,2629,3026,0.07750132657272568,0.011703319379753552
443,"Boone, NC",Micropolitan Statistical Area,"Boone, NC Micro Area",50972,56441,5380,3632,3570,62,372,4904,5276,0.09620968374794003,0.007298124460488111
444,"Borger, TX",Micropolitan Statistical Area,"Borger, TX Micro Area",22211,20677,-1572,2899,2447,452,75,-2104,-2029,-0.09472783755796678,0.0033767052361442533
445,"Bozeman, MT",Micropolitan Statistical Area,"Bozeman, MT Micro Area",89662,116806,27291,11805,5684,6121,2133,18801,20934,0.20968749302937698,0.02378934219624813
446,"Bradford, PA",Micropolitan Statistical Area,"Bradford, PA Micro Area",43347,40333,-3130,4209,5395,-1186,176,-2103,-1927,-0.048515468198491236,0.004060257918656425
447,"Brainerd, MN",Micropolitan Statistical Area,"Brainerd, MN Micro Area",91262,95572,4493,10431,10126,305,339,3925,4264,0.04300804277793605,0.0037145800004382986
448,"Branson, MO",Micropolitan Statistical Area,"Branson, MO Micro Area",51905,56104,4432,6469,5782,687,327,3423,3750,0.06594740391099123,0.006299971101049995
449,"Breckenridge, CO",Micropolitan Statistical Area,"Breckenridge, CO Micro Area",28075,30631,2637,2824,643,2181,1070,-653,417,-0.023259127337488868,0.03811219946571683
450,"Brenham, TX",Micropolitan Statistical Area,"Brenham, TX Micro Area",33695,35771,2084,4056,3938,118,212,1766,1978,0.05241133699361923,0.006291734678735717
451,"Brevard, NC",Micropolitan Statistical Area,"Brevard, NC Micro Area",33087,34498,1409,2741,4234,-1493,59,2854,2913,0.08625744250007555,0.0017831776830779461
452,"Brookhaven, MS",Micropolitan Statistical Area,"Brookhaven, MS Micro Area",34896,33936,-931,4446,4269,177,83,-1173,-1090,-0.03361416781292985,0.002378496102705181
453,"Brookings, OR",Micropolitan Statistical Area,"Brookings, OR Micro Area",22378,23305,941,1810,3828,-2018,-139,3093,2954,0.13821610510322638,-0.0062114576816516215
454,"Brookings, SD",Micropolitan Statistical Area,"Brookings, SD Micro Area",32003,35603,3637,4297,2010,2287,2050,-695,1355,-0.021716714058057057,0.06405649470362154
455,"Brownsville, TN",Micropolitan Statistical Area,"Brownsville, TN Micro Area",18811,17002,-1803,2146,2093,53,17,-1880,-1863,-0.09994152357663068,0.0009037265429801713
456,"Brownwood, TX",Micropolitan Statistical Area,"Brownwood, TX Micro Area",38076,37633,-473,4193,4991,-798,248,105,353,0.002757642609517807,0.006513289211051581
457,"Bucyrus-Galion, OH",Micropolitan Statistical Area,"Bucyrus-Galion, OH Micro Area",43754,41338,-2445,4838,5621,-783,219,-1875,-1656,-0.0428532248480139,0.0050052566622480225
458,"Burley, ID",Micropolitan Statistical Area,"Burley, ID Micro Area",43164,45493,2474,7186,3897,3289,323,-1146,-823,-0.026549902696691687,0.007483087758317116
459,"Burlington, IA-IL",Micropolitan Statistical Area,"Burlington, IA-IL Micro Area",47587,45243,-2411,5349,5648,-299,326,-2425,-2099,-0.0509592956059428,0.0068506104608401465
460,"Butte-Silver Bow, MT",Micropolitan Statistical Area,"Butte-Silver Bow, MT Micro Area",34235,35180,969,3977,4273,-296,788,502,1290,0.014663356214400469,0.023017379874397545
461,"Cadillac, MI",Micropolitan Statistical Area,"Cadillac, MI Micro Area",47553,48895,1314,5877,5331,546,165,627,792,0.0131852879944483,0.003469812630117973
462,"Calhoun, GA",Micropolitan Statistical Area,"Calhoun, GA Micro Area",55256,58780,3559,7090,5383,1707,434,1446,1880,0.026169103807731287,0.00785435065875199
463,"Cambridge, MD",Micropolitan Statistical Area,"Cambridge, MD Micro Area",32689,31853,-770,3800,3963,-163,302,-890,-588,-0.02722628407109425,0.00923858178592187
464,"Cambridge, OH",Micropolitan Statistical Area,"Cambridge, OH Micro Area",40152,38779,-1313,4644,4798,-154,84,-1223,-1139,-0.03045925483163977,0.0020920502092050207
465,"Camden, AR",Micropolitan Statistical Area,"Camden, AR Micro Area",31409,28280,-3216,3314,4270,-956,45,-2309,-2264,-0.07351396096660193,0.0014327103696392756
466,"Campbellsville, KY",Micropolitan Statistical Area,"Campbellsville, KY Micro Area",35895,36702,943,4487,4537,-50,392,600,992,0.016715419974926867,0.010920741050285556
467,"CaÒon City, CO",Micropolitan Statistical Area,"CaÒon City, CO Micro Area",46834,47867,1042,3854,5672,-1818,196,2642,2838,0.05641200836998761,0.004184993807917325
468,"Carlsbad-Artesia, NM",Micropolitan Statistical Area,"Carlsbad-Artesia, NM Micro Area",53912,58418,4590,8489,5802,2687,653,1221,1874,0.02264801899391601,0.012112331206410448
469,"Carroll, IA",Micropolitan Statistical Area,"Carroll, IA Micro Area",20823,19914,-902,2585,2468,117,48,-1067,-1019,-0.05124141574220813,0.002305143351102147
470,"Cedar City, UT",Micropolitan Statistical Area,"Cedar City, UT Micro Area",46264,56814,10651,8582,3176,5406,118,5111,5229,0.11047466712778836,0.002550579284108594
471,"Cedartown, GA",Micropolitan Statistical Area,"Cedartown, GA Micro Area",41537,42840,1353,5778,4970,808,217,332,549,0.007992873823338228,0.005224257890555408
472,"Celina, OH",Micropolitan Statistical Area,"Celina, OH Micro Area",40791,41274,456,6017,4203,1814,184,-1534,-1350,-0.0376063347307004,0.0045107989507489395
473,"Central City, KY",Micropolitan Statistical Area,"Central City, KY Micro Area",31659,30457,-1044,3589,3959,-370,-3,-666,-669,-0.02103667203638776,-9.475978394769259e-05
474,"Centralia, IL",Micropolitan Statistical Area,"Centralia, IL Micro Area",39416,37045,-2392,4989,5259,-270,155,-2267,-2112,-0.05751471483661458,0.00393241323320479
475,"Centralia, WA",Micropolitan Statistical Area,"Centralia, WA Micro Area",75503,82109,6652,9184,8969,215,588,5868,6456,0.07771876614174271,0.007787770022383215
476,"Charleston-Mattoon, IL",Micropolitan Statistical Area,"Charleston-Mattoon, IL Micro Area",64918,61032,-3889,6337,6395,-58,650,-4510,-3860,-0.06947225730922088,0.01001263131951077
477,"Chillicothe, OH",Micropolitan Statistical Area,"Chillicothe, OH Micro Area",78102,76420,-1659,8579,8659,-80,154,-1703,-1549,-0.021804819338813345,0.0019717804921768967
478,"Clarksburg, WV",Micropolitan Statistical Area,"Clarksburg, WV Micro Area",94318,91937,-2229,10253,11844,-1591,126,-718,-592,-0.007612544795267075,0.0013359061896986786
479,"Clarksdale, MS",Micropolitan Statistical Area,"Clarksdale, MS Micro Area",26111,21564,-4587,4115,3108,1007,-13,-5621,-5634,-0.21527325648194248,-0.0004978744590402513
480,"Clearlake, CA",Micropolitan Statistical Area,"Clearlake, CA Micro Area",64736,64479,-183,7553,8751,-1198,-166,1224,1058,0.018907563025210083,-0.002564260998517054
481,"Cleveland, MS",Micropolitan Statistical Area,"Cleveland, MS Micro Area",34104,30142,-4009,4953,4203,750,118,-4886,-4768,-0.14326765188834156,0.003460004691531785
482,"Clewiston, FL",Micropolitan Statistical Area,"Clewiston, FL Micro Area",39005,42813,3672,6050,3076,2974,3270,-2683,587,-0.06878605307011923,0.08383540571721575
483,"Clinton, IA",Micropolitan Statistical Area,"Clinton, IA Micro Area",49091,46392,-2721,5717,5692,25,373,-3137,-2764,-0.0639017335153083,0.007598134077529486
484,"Clovis, NM",Micropolitan Statistical Area,"Clovis, NM Micro Area",48977,48793,417,9060,4055,5005,1541,-6194,-4653,-0.12646752557322824,0.03146374829001368
485,"Coffeyville, KS",Micropolitan Statistical Area,"Coffeyville, KS Micro Area",35353,31502,-3966,4226,4483,-257,566,-4307,-3741,-0.12182841625887478,0.016009956722201794
486,"Coldwater, MI",Micropolitan Statistical Area,"Coldwater, MI Micro Area",45173,43424,-1818,5513,4601,912,417,-3154,-2737,-0.06982046797865983,0.009231177916011777
487,"Columbus, MS",Micropolitan Statistical Area,"Columbus, MS Micro Area",59796,58309,-1470,8139,6323,1816,953,-4226,-3273,-0.07067362365375611,0.015937520904408326
488,"Columbus, NE",Micropolitan Statistical Area,"Columbus, NE Micro Area",32305,33364,1127,4900,2898,2002,627,-1500,-873,-0.04643244079863798,0.019408760253830683
489,"Concord, NH",Micropolitan Statistical Area,"Concord, NH Micro Area",146395,152622,6170,13641,13959,-318,4151,2450,6601,0.016735544246729742,0.028354793538030675
490,"Connersville, IN",Micropolitan Statistical Area,"Connersville, IN Micro Area",24325,22892,-1410,2580,3280,-700,49,-748,-699,-0.030750256937307294,0.002014388489208633
491,"Cookeville, TN",Micropolitan Statistical Area,"Cookeville, TN Micro Area",106265,115359,9307,12550,12802,-252,1785,7821,9606,0.07359902131463793,0.016797628570084225
492,"Coos Bay, OR",Micropolitan Statistical Area,"Coos Bay, OR Micro Area",63010,64711,1656,6231,9259,-3028,187,4529,4716,0.07187747976511663,0.002967782891604507
493,"Cordele, GA",Micropolitan Statistical Area,"Cordele, GA Micro Area",23436,22034,-1401,2941,2608,333,72,-1827,-1755,-0.07795698924731183,0.0030721966205837174
494,"Corinth, MS",Micropolitan Statistical Area,"Corinth, MS Micro Area",37109,36889,-173,4445,4756,-311,118,51,169,0.0013743296774367405,0.003179821606618341
495,"Cornelia, GA",Micropolitan Statistical Area,"Cornelia, GA Micro Area",43058,46047,3019,5139,4540,599,529,1883,2412,0.04373171071577872,0.012285754099122114
496,"Corning, NY",Micropolitan Statistical Area,"Corning, NY Micro Area",98969,94657,-4289,10960,10277,683,634,-5592,-4958,-0.05650254119976963,0.006406046337742121
497,"Corsicana, TX",Micropolitan Statistical Area,"Corsicana, TX Micro Area",47870,50694,2854,7023,5463,1560,172,1148,1320,0.02398161687904742,0.003593064549822436
498,"Cortland, NY",Micropolitan Statistical Area,"Cortland, NY Micro Area",49277,47173,-2114,4827,4559,268,245,-2632,-2387,-0.05341234247214725,0.0049718935811839185
499,"Coshocton, OH",Micropolitan Statistical Area,"Coshocton, OH Micro Area",36938,36449,-451,4656,4206,450,66,-951,-885,-0.025745844387893225,0.0017867778439547351
500,"Craig, CO",Micropolitan Statistical Area,"Craig, CO Micro Area",13795,13144,-647,1803,1016,787,55,-1510,-1455,-0.10945994925697716,0.003986951794128307
501,"Crawfordsville, IN",Micropolitan Statistical Area,"Crawfordsville, IN Micro Area",38096,38365,244,4635,4104,531,170,-439,-269,-0.011523519529609408,0.004462410751784964
502,"Crescent City, CA",Micropolitan Statistical Area,"Crescent City, CA Micro Area",28568,27968,-642,3111,2968,143,157,-984,-827,-0.03444413329599552,0.005495659479137496
503,"Crossville, TN",Micropolitan Statistical Area,"Crossville, TN Micro Area",56193,61603,5545,5623,8369,-2746,318,7935,8253,0.14120975922267898,0.005659067855426833
504,"Cullman, AL",Micropolitan Statistical Area,"Cullman, AL Micro Area",80456,84515,4111,10046,10264,-218,241,4148,4389,0.051556130058665606,0.00299542607139306
505,"Cullowhee, NC",Micropolitan Statistical Area,"Cullowhee, NC Micro Area",54382,58212,3961,5811,5760,51,548,3354,3902,0.0616748188738921,0.01007686366812548
506,"Danville, KY",Micropolitan Statistical Area,"Danville, KY Micro Area",53398,54833,1658,6553,6326,227,162,1253,1415,0.023465298325779992,0.003033821491441627
507,"Danville, VA",Micropolitan Statistical Area,"Danville, VA Micro Area",106516,99719,-6823,10451,14494,-4043,584,-3317,-2733,-0.03114086146682189,0.00548274437643171
508,"Dayton, TN",Micropolitan Statistical Area,"Dayton, TN Micro Area",31860,33443,1639,3949,4077,-128,284,1496,1780,0.04695543000627746,0.008913998744507219
509,"Decatur, IN",Micropolitan Statistical Area,"Decatur, IN Micro Area",34442,35839,1455,6819,3165,3654,79,-2287,-2208,-0.0664014865571105,0.00229371116659892
510,"Defiance, OH",Micropolitan Statistical Area,"Defiance, OH Micro Area",39083,37778,-1248,4447,4076,371,258,-1885,-1627,-0.04823068853465701,0.006601335619067113
511,"Del Rio, TX",Micropolitan Statistical Area,"Del Rio, TX Micro Area",48963,49028,149,8602,3701,4901,752,-5549,-4797,-0.11333047403141147,0.015358536037416009
512,"Deming, NM",Micropolitan Statistical Area,"Deming, NM Micro Area",25082,23905,-1190,3894,3070,824,248,-2265,-2017,-0.09030380352443984,0.009887568774419904
513,"DeRidder, LA",Micropolitan Statistical Area,"DeRidder, LA Micro Area",35832,37881,2228,5160,3862,1298,365,572,937,0.015963384684081268,0.010186425541415495
514,"Dickinson, ND",Micropolitan Statistical Area,"Dickinson, ND Micro Area",25142,32997,8015,5067,2441,2626,630,4555,5185,0.18117094900962533,0.025057672420650705
515,"Dixon, IL",Micropolitan Statistical Area,"Dixon, IL Micro Area",35978,33647,-2387,3544,3806,-262,25,-2150,-2125,-0.05975874145311024,0.0006948690866640725
516,"Dodge City, KS",Micropolitan Statistical Area,"Dodge City, KS Micro Area",34006,33094,-750,6512,2474,4038,1883,-6714,-4831,-0.19743574663294716,0.05537258130918074
517,"Douglas, GA",Micropolitan Statistical Area,"Douglas, GA Micro Area",51092,51611,885,7303,4916,2387,323,-1877,-1554,-0.036737649729899007,0.006321929069130197
518,"Dublin, GA",Micropolitan Statistical Area,"Dublin, GA Micro Area",65271,64001,-1296,8335,7578,757,145,-2185,-2040,-0.03347581621240674,0.002221507254370241
519,"DuBois, PA",Micropolitan Statistical Area,"DuBois, PA Micro Area",81543,78612,-2997,7535,9714,-2179,578,-1341,-763,-0.016445311062874803,0.007088284708681309
520,"Dumas, TX",Micropolitan Statistical Area,"Dumas, TX Micro Area",22008,20654,-1250,4223,1460,2763,943,-5001,-4058,-0.22723555070883314,0.042848055252635416
521,"Duncan, OK",Micropolitan Statistical Area,"Duncan, OK Micro Area",45105,43100,-1951,5446,5807,-361,276,-1850,-1574,-0.04101540849129808,0.006119055537080146
522,"Durango, CO",Micropolitan Statistical Area,"Durango, CO Micro Area",51416,56564,5229,5287,3448,1839,140,3205,3345,0.06233468181110938,0.0027228878170219386
523,"Durant, OK",Micropolitan Statistical Area,"Durant, OK Micro Area",42579,48998,6582,6074,5261,813,287,5471,5758,0.12849057046901055,0.006740411940158294
524,"Dyersburg, TN",Micropolitan Statistical Area,"Dyersburg, TN Micro Area",38320,36693,-1638,4815,4704,111,70,-1810,-1740,-0.04723382045929018,0.0018267223382045926
525,"Eagle Pass, TX",Micropolitan Statistical Area,"Eagle Pass, TX Micro Area",54424,58378,4120,10988,3866,7122,1330,-4337,-3007,-0.07968910774658239,0.024437748052329854
526,"Easton, MD",Micropolitan Statistical Area,"Easton, MD Micro Area",37876,36972,-805,3423,4596,-1173,212,193,405,0.0050955750343225255,0.005597211954799872
527,"Edwards, CO",Micropolitan Statistical Area,"Edwards, CO Micro Area",52098,54929,2729,6415,1227,5188,1233,-3711,-2478,-0.07123114131060693,0.023666935390993897
528,"Effingham, IL",Micropolitan Statistical Area,"Effingham, IL Micro Area",34222,34065,-179,4623,3672,951,216,-1339,-1123,-0.03912687744725615,0.006311729296943487
529,"El Campo, TX",Micropolitan Statistical Area,"El Campo, TX Micro Area",41280,41685,405,5799,4353,1446,88,-1109,-1021,-0.02686531007751938,0.002131782945736434
530,"El Dorado, AR",Micropolitan Statistical Area,"El Dorado, AR Micro Area",41570,38219,-3415,5146,5474,-328,45,-3155,-3110,-0.07589607890305508,0.001082511426509502
531,"Elizabeth City, NC",Micropolitan Statistical Area,"Elizabeth City, NC Micro Area",54112,54039,-74,6287,5898,389,663,-1148,-485,-0.021215257244234183,0.012252365464222354
532,"Elk City, OK",Micropolitan Statistical Area,"Elk City, OK Micro Area",22056,21468,-651,3451,2503,948,12,-1646,-1634,-0.07462821907870874,0.000544069640914037
533,"Elkins, WV",Micropolitan Statistical Area,"Elkins, WV Micro Area",29360,28387,-1015,3022,3760,-738,99,-358,-259,-0.012193460490463215,0.003371934604904632
534,"Elko, NV",Micropolitan Statistical Area,"Elko, NV Micro Area",51083,55071,4142,7381,2938,4443,-65,-337,-402,-0.006597106669537811,-0.0012724389718693108
535,"Ellensburg, WA",Micropolitan Statistical Area,"Ellensburg, WA Micro Area",40992,49204,8294,4190,3144,1046,709,6517,7226,0.15898224043715847,0.01729605776736924
536,"Emporia, KS",Micropolitan Statistical Area,"Emporia, KS Micro Area",36431,35631,-851,4472,3283,1189,739,-2810,-2071,-0.07713211276111004,0.02028492218165848
537,"Enterprise, AL",Micropolitan Statistical Area,"Enterprise, AL Micro Area",50204,53230,3279,6389,5330,1059,1027,1176,2203,0.023424428332403796,0.020456537327702973
538,"Escanaba, MI",Micropolitan Statistical Area,"Escanaba, MI Micro Area",37049,35612,-1457,3652,4540,-888,23,-567,-544,-0.01530405678965694,0.0006207994817673891
539,"EspaÒola, NM",Micropolitan Statistical Area,"EspaÒola, NM Micro Area",40286,38521,-1699,5174,4197,977,320,-3000,-2680,-0.07446755696768108,0.00794320607655265
540,"Eufaula, AL-GA",Micropolitan Statistical Area,"Eufaula, AL-GA Micro Area",29837,26860,-3104,3099,3571,-472,36,-2681,-2645,-0.08985487817139792,0.0012065556188624864
541,"Eureka-Arcata, CA",Micropolitan Statistical Area,"Eureka-Arcata, CA Micro Area",135010,134977,364,14896,13697,1199,451,-1251,-800,-0.009265980297755721,0.0033404932967928303
542,"Evanston, WY",Micropolitan Statistical Area,"Evanston, WY Micro Area",21090,20215,-906,2959,1488,1471,-48,-2356,-2404,-0.11171171171171172,-0.002275960170697013
543,"Fairfield, IA",Micropolitan Statistical Area,"Fairfield, IA Micro Area",16835,18347,1511,1534,1703,-169,2268,-589,1679,-0.034986634986634985,0.13471933471933473
544,"Fairmont, MN",Micropolitan Statistical Area,"Fairmont, MN Micro Area",20805,19484,-1359,2343,2559,-216,12,-1152,-1140,-0.05537130497476568,0.0005767844268204759
545,"Fairmont, WV",Micropolitan Statistical Area,"Fairmont, WV Micro Area",56566,55962,-489,6449,6971,-522,190,-110,80,-0.0019446310504543363,0.0033589081780574905
546,"Fallon, NV",Micropolitan Statistical Area,"Fallon, NV Micro Area",24816,25363,488,3311,2825,486,441,-461,-20,-0.01857672469374597,0.017770793036750485
547,"Faribault-Northfield, MN",Micropolitan Statistical Area,"Faribault-Northfield, MN Micro Area",64231,67084,2951,7495,5024,2471,1782,-1294,488,-0.02014603540346561,0.027743612897199173
548,"Farmington, MO",Micropolitan Statistical Area,"Farmington, MO Micro Area",65534,66485,1116,7393,7951,-558,20,1668,1688,0.02545243690298166,0.00030518509475997187
549,"Fergus Falls, MN",Micropolitan Statistical Area,"Fergus Falls, MN Micro Area",57291,58741,1440,6595,6899,-304,433,1371,1804,0.02393046028171964,0.007557906128362221
550,"Fernley, NV",Micropolitan Statistical Area,"Fernley, NV Micro Area",52049,58319,6334,5938,6052,-114,-233,6670,6437,0.12814847547503316,-0.0044765509423812175
551,"Findlay, OH",Micropolitan Statistical Area,"Findlay, OH Micro Area",74698,75407,617,9234,7637,1597,1355,-2310,-955,-0.030924522744919542,0.01813970922916276
552,"Fitzgerald, GA",Micropolitan Statistical Area,"Fitzgerald, GA Micro Area",17649,16614,-1048,2336,2276,60,49,-1155,-1106,-0.0654428012918579,0.002776361266927305
553,"Forest City, NC",Micropolitan Statistical Area,"Forest City, NC Micro Area",67739,67076,-743,6919,8775,-1856,57,1125,1182,0.016607862531185874,0.0008414650349134178
554,"Forrest City, AR",Micropolitan Statistical Area,"Forrest City, AR Micro Area",28131,24682,-3564,3434,2964,470,240,-4309,-4069,-0.1531762112971455,0.008531513277167538
555,"Fort Dodge, IA",Micropolitan Statistical Area,"Fort Dodge, IA Micro Area",37882,35934,-2077,4515,4574,-59,513,-2538,-2025,-0.06699751861042183,0.013542051634021435
556,"Fort Leonard Wood, MO",Micropolitan Statistical Area,"Fort Leonard Wood, MO Micro Area",52865,52709,427,8086,3184,4902,2627,-7217,-4590,-0.13651754468930294,0.04969261326019105
557,"Fort Madison-Keokuk, IA-IL-MO",Micropolitan Statistical Area,"Fort Madison-Keokuk, IA-IL-MO Micro Area",62080,57732,-4366,6769,7420,-651,107,-3820,-3713,-0.06153350515463917,0.0017235824742268039
558,"Fort Morgan, CO",Micropolitan Statistical Area,"Fort Morgan, CO Micro Area",28243,28941,782,4443,2683,1760,1175,-2165,-990,-0.0766561625889601,0.041603229118719685
559,"Fort Payne, AL",Micropolitan Statistical Area,"Fort Payne, AL Micro Area",71133,71658,568,8600,8124,476,607,-475,132,-0.00667763204138726,0.008533310840256983
560,"Fort Polk South, LA",Micropolitan Statistical Area,"Fort Polk South, LA Micro Area",52737,47894,-4463,10086,4079,6007,1939,-12535,-10596,-0.23768890911504256,0.03676735498795912
561,"Frankfort, IN",Micropolitan Statistical Area,"Frankfort, IN Micro Area",33222,32206,-1013,4494,3717,777,64,-1868,-1804,-0.056227800854855216,0.0019264342905303716
562,"Frankfort, KY",Micropolitan Statistical Area,"Frankfort, KY Micro Area",70726,73951,3220,8502,7741,761,755,1756,2511,0.024828210276277463,0.010674999293046404
563,"Fredericksburg, TX",Micropolitan Statistical Area,"Fredericksburg, TX Micro Area",24875,26960,2132,2544,3644,-1100,355,2881,3236,0.11581909547738692,0.014271356783919597
564,"Freeport, IL",Micropolitan Statistical Area,"Freeport, IL Micro Area",47606,43831,-3873,5034,5614,-580,209,-3513,-3304,-0.07379321934209973,0.004390202915598874
565,"Fremont, NE",Micropolitan Statistical Area,"Fremont, NE Micro Area",36671,36222,-461,4914,4513,401,458,-1306,-848,-0.03561397289411252,0.012489433067001171
566,"Fremont, OH",Micropolitan Statistical Area,"Fremont, OH Micro Area",60886,58351,-2595,6771,6719,52,126,-2772,-2646,-0.04552770751896988,0.002069441250862267
567,"Gaffney, SC",Micropolitan Statistical Area,"Gaffney, SC Micro Area",55534,57316,1832,6885,6562,323,3,1547,1550,0.02785680844167537,5.4020960132531424e-05
568,"Gainesville, TX",Micropolitan Statistical Area,"Gainesville, TX Micro Area",38482,41393,2948,5515,4225,1290,315,1351,1666,0.03510732290421496,0.008185645236734058
569,"Galesburg, IL",Micropolitan Statistical Area,"Galesburg, IL Micro Area",52911,49053,-3870,5670,6902,-1232,838,-3445,-2607,-0.06510933454291168,0.015837916501294628
570,"Gallup, NM",Micropolitan Statistical Area,"Gallup, NM Micro Area",71673,70824,-661,10844,6225,4619,630,-5930,-5300,-0.08273687441574931,0.008789920890711983
571,"Garden City, KS",Micropolitan Statistical Area,"Garden City, KS Micro Area",40952,39662,-1105,7529,2562,4967,1239,-7360,-6121,-0.17972260207071694,0.030254932604024225
572,"Gardnerville Ranchos, NV",Micropolitan Statistical Area,"Gardnerville Ranchos, NV Micro Area",47037,49088,2088,3386,5034,-1648,29,3742,3771,0.07955439334991603,0.0006165359185322192
573,"Georgetown, SC",Micropolitan Statistical Area,"Georgetown, SC Micro Area",60343,63353,3029,5766,7792,-2026,155,4930,5085,0.08169961718840628,0.0025686492219478647
574,"Gillette, WY",Micropolitan Statistical Area,"Gillette, WY Micro Area",60570,61012,591,8994,4018,4976,222,-4683,-4461,-0.07731550272412085,0.0036651807825656265
575,"Glasgow, KY",Micropolitan Statistical Area,"Glasgow, KY Micro Area",52252,54358,2089,6970,6480,490,263,1361,1624,0.02604684988134425,0.005033300160759396
576,"Glenwood Springs, CO",Micropolitan Statistical Area,"Glenwood Springs, CO Micro Area",73228,78260,4742,9637,3892,5745,1154,-2183,-1029,-0.02981100125635003,0.015758999289889112
577,"Gloversville, NY",Micropolitan Statistical Area,"Gloversville, NY Micro Area",55453,52812,-2697,5429,6218,-789,139,-2030,-1891,-0.03660757758822787,0.0025066272338737307
578,"Granbury, TX",Micropolitan Statistical Area,"Granbury, TX Micro Area",51268,63527,12366,6041,6927,-886,350,12849,13199,0.2506241710228603,0.006826870562534134
579,"Grand Rapids, MN",Micropolitan Statistical Area,"Grand Rapids, MN Micro Area",45034,45268,213,4704,5344,-640,87,814,901,0.0180752320468979,0.0019318736954301195
580,"Grants, NM",Micropolitan Statistical Area,"Grants, NM Micro Area",27319,26354,-864,3647,2690,957,227,-2059,-1832,-0.07536879095135254,0.008309235330722208
581,"Great Bend, KS",Micropolitan Statistical Area,"Great Bend, KS Micro Area",27675,25658,-2014,3504,3076,428,143,-2582,-2439,-0.09329719963866304,0.005167118337850046
582,"Greeneville, TN",Micropolitan Statistical Area,"Greeneville, TN Micro Area",68834,69571,746,6607,9325,-2718,174,3342,3516,0.0485515878780835,0.002527820553796089
583,"Greensburg, IN",Micropolitan Statistical Area,"Greensburg, IN Micro Area",25795,26584,847,3416,2776,640,224,2,226,7.753440589261485e-05,0.008683853459972864
584,"Greenville, MS",Micropolitan Statistical Area,"Greenville, MS Micro Area",51098,42837,-8298,7275,6123,1152,163,-9671,-9508,-0.18926376766213945,0.0031899487259775326
585,"Greenville, OH",Micropolitan Statistical Area,"Greenville, OH Micro Area",52964,51205,-1763,6372,6170,202,125,-2079,-1954,-0.03925307756211766,0.002360093648515973
586,"Greenwood, MS",Micropolitan Statistical Area,"Greenwood, MS Micro Area",43026,37586,-5397,5679,4881,798,101,-6368,-6267,-0.14800353274764094,0.002347417840375587
587,"Greenwood, SC",Micropolitan Statistical Area,"Greenwood, SC Micro Area",69759,71074,1391,8745,7785,960,907,-442,465,-0.006336100001433507,0.01300190656402758
588,"Grenada, MS",Micropolitan Statistical Area,"Grenada, MS Micro Area",21837,20610,-1293,2755,3044,-289,-26,-966,-992,-0.04423684572056601,-0.0011906397398910107
589,"Guymon, OK",Micropolitan Statistical Area,"Guymon, OK Micro Area",20800,19997,-643,3765,1673,2092,1139,-3914,-2775,-0.1881730769230769,0.05475961538461538
590,"Hailey, ID",Micropolitan Statistical Area,"Hailey, ID Micro Area",22411,24556,2062,2268,1191,1077,1068,-89,979,-0.003971264111373879,0.047655169336486544
591,"Hannibal, MO",Micropolitan Statistical Area,"Hannibal, MO Micro Area",38981,38722,-234,4749,4367,382,151,-738,-587,-0.018932300351453272,0.0038736820502295994
592,"Harrison, AR",Micropolitan Statistical Area,"Harrison, AR Micro Area",45198,45227,-6,5228,5583,-355,-8,385,377,0.008518076021062878,-0.00017699898225585206
593,"Hastings, NE",Micropolitan Statistical Area,"Hastings, NE Micro Area",31328,31321,-46,4138,3208,930,478,-1441,-963,-0.04599719101123596,0.015257916241062309
594,"Hays, KS",Micropolitan Statistical Area,"Hays, KS Micro Area",28424,28671,219,3562,2567,995,627,-1412,-785,-0.04967632986208838,0.02205882352941177
595,"Heber, UT",Micropolitan Statistical Area,"Heber, UT Micro Area",60144,77799,17950,8659,2870,5789,1604,10479,12083,0.174231843575419,0.02666932694865656
596,"Helena, MT",Micropolitan Statistical Area,"Helena, MT Micro Area",74984,82589,7792,8664,7253,1411,415,5986,6401,0.07983036381094634,0.005534514029659661
597,"Helena-West Helena, AR",Micropolitan Statistical Area,"Helena-West Helena, AR Micro Area",21675,17299,-4456,2989,2744,245,-14,-4741,-4755,-0.21873125720876585,-0.0006459054209919262
598,"Henderson, NC",Micropolitan Statistical Area,"Henderson, NC Micro Area",45293,44718,-694,5795,5283,512,474,-1684,-1210,-0.03718013821120261,0.010465193296977458
599,"Hereford, TX",Micropolitan Statistical Area,"Hereford, TX Micro Area",19465,18277,-1095,3438,1527,1911,173,-3210,-3037,-0.16491137939892114,0.008887747238633444
600,"Hermiston-Pendleton, OR",Micropolitan Statistical Area,"Hermiston-Pendleton, OR Micro Area",87300,89452,2390,12163,7525,4638,236,-2474,-2238,-0.028339060710194725,0.0027033218785796104
601,"Hillsdale, MI",Micropolitan Statistical Area,"Hillsdale, MI Micro Area",46646,45658,-1033,5448,4952,496,55,-1572,-1517,-0.03370063885434978,0.0011790935985936631
602,"Hilo, HI",Micropolitan Statistical Area,"Hilo, HI Micro Area",185361,203340,18264,23915,17545,6370,5650,6312,11962,0.03405247058442715,0.030481061280420368
603,"Hobbs, NM",Micropolitan Statistical Area,"Hobbs, NM Micro Area",64598,71830,7104,11435,5556,5879,1309,-163,1146,-0.0025232979349205857,0.02026378525650949
604,"Holland, MI",Micropolitan Statistical Area,"Holland, MI Micro Area",111521,118927,7529,14015,9922,4093,625,2870,3495,0.02573506335129707,0.005604325642704065
605,"Hood River, OR",Micropolitan Statistical Area,"Hood River, OR Micro Area",22447,23280,934,2795,1839,956,25,-38,-13,-0.0016928765536597318,0.0011137345747761393
606,"Hope, AR",Micropolitan Statistical Area,"Hope, AR Micro Area",31598,29352,-2256,4253,3709,544,-87,-2719,-2806,-0.08604974998417621,-0.002753338818912589
607,"Houghton, MI",Micropolitan Statistical Area,"Houghton, MI Micro Area",38899,37245,-1536,3974,3881,93,1393,-3038,-1645,-0.07809969407953933,0.035810689220802584
608,"Hudson, NY",Micropolitan Statistical Area,"Hudson, NY Micro Area",63035,59534,-3529,5249,6954,-1705,592,-2378,-1786,-0.037725073371936216,0.009391607836916002
609,"Huntingdon, PA",Micropolitan Statistical Area,"Huntingdon, PA Micro Area",45999,44590,-1412,4142,4894,-752,306,-931,-625,-0.020239570425444036,0.0066523185286636675
610,"Huntington, IN",Micropolitan Statistical Area,"Huntington, IN Micro Area",37115,36395,-728,4331,4205,126,154,-1002,-848,-0.02699717095513943,0.004149265795500471
611,"Huntsville, TX",Micropolitan Statistical Area,"Huntsville, TX Micro Area",68239,72164,4302,6323,5475,848,1539,1874,3413,0.02746230161637773,0.0225530854789783
612,"Huron, SD",Micropolitan Statistical Area,"Huron, SD Micro Area",19497,20498,1028,3414,2269,1145,1716,-1843,-127,-0.0945273631840796,0.08801354054469919
613,"Hutchinson, KS",Micropolitan Statistical Area,"Hutchinson, KS Micro Area",64552,61793,-2718,7189,7634,-445,297,-2538,-2241,-0.03931713967034329,0.004600941876316768
614,"Hutchinson, MN",Micropolitan Statistical Area,"Hutchinson, MN Micro Area",36592,35710,-935,4195,3474,721,111,-1779,-1668,-0.048617184083952776,0.003033449934411893
615,"Indiana, PA",Micropolitan Statistical Area,"Indiana, PA Micro Area",88864,83664,-5217,8407,9395,-988,752,-4980,-4228,-0.056040691393590206,0.008462369463449766
616,"Indianola, MS",Micropolitan Statistical Area,"Indianola, MS Micro Area",28983,24740,-4643,3242,3147,95,50,-4872,-4822,-0.1680985405237553,0.001725149225407998
617,"Iron Mountain, MI-WI",Micropolitan Statistical Area,"Iron Mountain, MI-WI Micro Area",30554,29410,-1181,2839,3750,-911,46,-301,-255,-0.009851410617267787,0.0015055311906787981
618,"Jackson, OH",Micropolitan Statistical Area,"Jackson, OH Micro Area",33249,32493,-726,4244,4258,-14,170,-877,-707,-0.026376733134831118,0.005112935727390297
619,"Jackson, WY-ID",Micropolitan Statistical Area,"Jackson, WY-ID Micro Area",31447,35998,4535,4020,1333,2687,662,1140,1802,0.036251470728527364,0.02105129265112729
620,"Jacksonville, IL",Micropolitan Statistical Area,"Jacksonville, IL Micro Area",40829,38350,-2550,4159,4649,-490,432,-2479,-2047,-0.06071664748095716,0.010580714688089349
621,"Jacksonville, TX",Micropolitan Statistical Area,"Jacksonville, TX Micro Area",50932,52875,2048,7618,5506,2112,140,-165,-25,-0.0032396136024503263,0.0027487630566245193
622,"Jamestown, ND",Micropolitan Statistical Area,"Jamestown, ND Micro Area",21138,20498,-602,2367,2464,-97,187,-679,-492,-0.03212224429936607,0.00884662692780774
623,"Jamestown-Dunkirk-Fredonia, NY",Micropolitan Statistical Area,"Jamestown-Dunkirk-Fredonia, NY Micro Area",134726,126032,-8875,13986,15082,-1096,1650,-9477,-7827,-0.07034276976975491,0.012247079257158974
624,"Jasper, AL",Micropolitan Statistical Area,"Jasper, AL Micro Area",66995,63143,-3876,8097,10271,-2174,163,-1821,-1658,-0.02718113292036719,0.002433017389357415
625,"Jasper, IN",Micropolitan Statistical Area,"Jasper, IN Micro Area",54621,54920,339,6956,5667,1289,573,-1505,-932,-0.02755350506215558,0.010490470698083156
626,"Jefferson, GA",Micropolitan Statistical Area,"Jefferson, GA Micro Area",60706,76199,15729,8387,5889,2498,282,12936,13218,0.21309261028563894,0.0046453398346127245
627,"Jennings, LA",Micropolitan Statistical Area,"Jennings, LA Micro Area",31629,31208,-381,4354,3882,472,77,-917,-840,-0.028992380410382875,0.0024344746909481805
628,"Jesup, GA",Micropolitan Statistical Area,"Jesup, GA Micro Area",30080,30023,-79,3979,3463,516,158,-776,-618,-0.02579787234042553,0.005252659574468085
629,"Juneau, AK",Micropolitan Statistical Area,"Juneau, AK Micro Area",31387,31849,573,3772,1917,1855,698,-1985,-1287,-0.063242743811132,0.02223850638799503
630,"Kalispell, MT",Micropolitan Statistical Area,"Kalispell, MT Micro Area",90863,105851,14929,11423,8967,2456,359,12082,12441,0.1329694154936553,0.003951003158601411
631,"Kapaa, HI",Micropolitan Statistical Area,"Kapaa, HI Micro Area",67208,71851,4756,8626,6054,2572,2756,-519,2237,-0.007722294964885133,0.041007022973455536
632,"Kearney, NE",Micropolitan Statistical Area,"Kearney, NE Micro Area",52652,56766,4178,7770,4392,3378,902,-91,811,-0.0017283294081896225,0.01713135303502241
633,"Keene, NH",Micropolitan Statistical Area,"Keene, NH Micro Area",77063,76228,-895,6878,7398,-520,726,-1067,-341,-0.013845814463490909,0.009420863449385568
634,"Kendallville, IN",Micropolitan Statistical Area,"Kendallville, IN Micro Area",47455,47832,294,6270,4630,1640,128,-1461,-1333,-0.03078706142661469,0.002697292171530924
635,"Kennett, MO",Micropolitan Statistical Area,"Kennett, MO Micro Area",31951,28878,-3081,4338,4502,-164,267,-3200,-2933,-0.10015335983224312,0.008356545961002786
636,"Kerrville, TX",Micropolitan Statistical Area,"Kerrville, TX Micro Area",49640,52869,3226,5294,7469,-2175,363,5038,5401,0.10149073327961322,0.007312651087832394
637,"Ketchikan, AK",Micropolitan Statistical Area,"Ketchikan, AK Micro Area",13584,13747,213,1668,977,691,414,-894,-480,-0.06581272084805652,0.030477031802120143
638,"Key West, FL",Micropolitan Statistical Area,"Key West, FL Micro Area",73226,73900,810,7368,7228,140,3537,-2886,651,-0.0394122306284653,0.04830251549995903
639,"Kill Devil Hills, NC",Micropolitan Statistical Area,"Kill Devil Hills, NC Micro Area",33981,37547,3627,3525,3356,169,361,3094,3455,0.09105088137488596,0.01062358376739943
640,"Kingsville, TX",Micropolitan Statistical Area,"Kingsville, TX Micro Area",32454,30717,-1757,4583,2685,1898,893,-4597,-3704,-0.1416466383188513,0.027515868614038333
641,"Kinston, NC",Micropolitan Statistical Area,"Kinston, NC Micro Area",59491,55720,-3791,6631,7408,-777,274,-3283,-3009,-0.05518481787161083,0.0046057386831621595
642,"Kirksville, MO",Micropolitan Statistical Area,"Kirksville, MO Micro Area",30079,29933,-115,3414,2788,626,1038,-1783,-745,-0.05927723661025965,0.03450912596828352
643,"Klamath Falls, OR",Micropolitan Statistical Area,"Klamath Falls, OR Micro Area",66323,68739,2356,8128,8029,99,90,2194,2284,0.03308053013283476,0.0013569953108273148
644,"Laconia, NH",Micropolitan Statistical Area,"Laconia, NH Micro Area",60101,61551,1476,5291,7132,-1841,580,2790,3370,0.0464218565414885,0.009650421789986856
645,"La Grande, OR",Micropolitan Statistical Area,"La Grande, OR Micro Area",25725,26551,814,3002,2831,171,230,424,654,0.016482021379980564,0.008940719144800777
646,"LaGrange, GA-AL",Micropolitan Statistical Area,"LaGrange, GA-AL Micro Area",101165,103079,1883,13212,11809,1403,1175,-640,535,-0.0063262986210645975,0.011614688874610785
647,"Lake City, FL",Micropolitan Statistical Area,"Lake City, FL Micro Area",67558,72654,5128,8215,8219,-4,395,4744,5139,0.07022114331389323,0.005846827910832174
648,"Lamesa, TX",Micropolitan Statistical Area,"Lamesa, TX Micro Area",13826,12974,-859,1919,1401,518,149,-1571,-1422,-0.11362650079560248,0.01077679733834804
649,"Laramie, WY",Micropolitan Statistical Area,"Laramie, WY Micro Area",36471,38950,2651,3993,1963,2030,1535,-929,606,-0.025472293054755832,0.04208823448767514
650,"Las Vegas, NM",Micropolitan Statistical Area,"Las Vegas, NM Micro Area",34285,31622,-2634,3402,3367,35,662,-3365,-2703,-0.09814787808079337,0.019308735598658304
651,"Laurel, MS",Micropolitan Statistical Area,"Laurel, MS Micro Area",84832,84325,-520,11969,9829,2140,143,-2781,-2638,-0.03278244058845719,0.0016856846473029044
652,"Laurinburg, NC",Micropolitan Statistical Area,"Laurinburg, NC Micro Area",36062,34637,-1523,4623,4139,484,167,-2183,-2016,-0.06053463479562975,0.004630913426875936
653,"Lawrenceburg, TN",Micropolitan Statistical Area,"Lawrenceburg, TN Micro Area",41971,44432,2573,5815,5494,321,44,2223,2267,0.052965142598460836,0.001048342903433323
654,"Lebanon, MO",Micropolitan Statistical Area,"Lebanon, MO Micro Area",35697,35895,301,4883,4185,698,30,-425,-395,-0.011905762388996276,0.0008404067568703253
655,"Lebanon, NH-VT",Micropolitan Statistical Area,"Lebanon, NH-VT Micro Area",218426,217783,-686,19072,21805,-2733,3847,-1652,2195,-0.0075632021828903155,0.01761237215349821
656,"Levelland, TX",Micropolitan Statistical Area,"Levelland, TX Micro Area",22827,22921,23,3240,2199,1041,131,-1146,-1015,-0.05020370613746879,0.005738818066324966
657,"Lewisburg, PA",Micropolitan Statistical Area,"Lewisburg, PA Micro Area",45005,44294,-674,4122,3937,185,466,-1340,-874,-0.02977446950338852,0.010354405066103769
658,"Lewisburg, TN",Micropolitan Statistical Area,"Lewisburg, TN Micro Area",30688,35016,4405,3943,3425,518,371,3532,3903,0.11509384775808132,0.01208941605839416
659,"Lewistown, PA",Micropolitan Statistical Area,"Lewistown, PA Micro Area",46638,46064,-613,5965,5582,383,106,-1065,-959,-0.022835456065869036,0.002272824735194477
660,"Lexington, NE",Micropolitan Statistical Area,"Lexington, NE Micro Area",26342,25496,-864,4271,2408,1863,1018,-3774,-2756,-0.14326930377344166,0.03864550907296333
661,"Liberal, KS",Micropolitan Statistical Area,"Liberal, KS Micro Area",22972,21038,-1912,4355,1325,3030,955,-5929,-4974,-0.2580968135121017,0.041572348946543616
662,"Lincoln, IL",Micropolitan Statistical Area,"Lincoln, IL Micro Area",30282,28383,-1922,3067,3425,-358,141,-1715,-1574,-0.056634304207119734,0.004656231424608678
663,"Lock Haven, PA",Micropolitan Statistical Area,"Lock Haven, PA Micro Area",39262,37957,-1291,4319,4171,148,125,-1557,-1432,-0.0396566654780704,0.0031837400030563907
664,"Logansport, IN",Micropolitan Statistical Area,"Logansport, IN Micro Area",38985,37388,-1582,4822,4140,682,881,-3164,-2283,-0.08115942028985508,0.022598435295626523
665,"London, KY",Micropolitan Statistical Area,"London, KY Micro Area",148225,148342,245,20009,18182,1827,426,-1962,-1536,-0.013236633496373756,0.002874009107775341
666,"Los Alamos, NM",Micropolitan Statistical Area,"Los Alamos, NM Micro Area",17995,19462,1512,1744,1267,477,766,241,1007,0.013392609058071686,0.04256737982772992
667,"Ludington, MI",Micropolitan Statistical Area,"Ludington, MI Micro Area",28719,29164,475,2931,3464,-533,120,913,1033,0.03179080051533828,0.004178418468609631
668,"Lufkin, TX",Micropolitan Statistical Area,"Lufkin, TX Micro Area",86905,86796,25,12042,9224,2818,168,-2915,-2747,-0.03354237385650998,0.0019331453886427708
669,"Lumberton, NC",Micropolitan Statistical Area,"Lumberton, NC Micro Area",134469,129999,-4206,18581,13843,4738,522,-9437,-8915,-0.07017974403022258,0.003881935613412757
670,"Macomb, IL",Micropolitan Statistical Area,"Macomb, IL Micro Area",32631,29295,-3321,2875,3154,-279,815,-3891,-3076,-0.11924243817229015,0.02497624957862156
671,"Madison, IN",Micropolitan Statistical Area,"Madison, IN Micro Area",32399,32110,-290,3748,3864,-116,158,-312,-154,-0.009629926849594123,0.004876693725114973
672,"Madisonville, KY",Micropolitan Statistical Area,"Madisonville, KY Micro Area",46841,44662,-2255,5507,6135,-628,226,-1837,-1611,-0.03921777929591597,0.004824832945496467
673,"Magnolia, AR",Micropolitan Statistical Area,"Magnolia, AR Micro Area",24722,23331,-1221,2981,3117,-136,235,-1349,-1114,-0.054566782622765146,0.009505703422053232
674,"Malone, NY",Micropolitan Statistical Area,"Malone, NY Micro Area",51642,49965,-1632,5020,4778,242,204,-2108,-1904,-0.04081948801363231,0.00395027303357732
675,"Malvern, AR",Micropolitan Statistical Area,"Malvern, AR Micro Area",33236,33787,771,3658,4095,-437,79,1109,1188,0.03336743290407991,0.0023769406667469013
676,"Manitowoc, WI",Micropolitan Statistical Area,"Manitowoc, WI Micro Area",81330,78757,-2687,8197,8846,-649,464,-2492,-2028,-0.030640600024591173,0.005705151850485675
677,"Marietta, OH",Micropolitan Statistical Area,"Marietta, OH Micro Area",61714,59652,-2135,6216,7590,-1374,283,-995,-712,-0.016122759827591794,0.004585669378098973
678,"Marinette, WI-MI",Micropolitan Statistical Area,"Marinette, WI-MI Micro Area",65630,62870,-2908,5878,8138,-2260,114,-710,-596,-0.01081822337345726,0.0017370105134846866
679,"Marion, IN",Micropolitan Statistical Area,"Marion, IN Micro Area",69906,65225,-4838,7837,8508,-671,246,-4416,-4170,-0.0631705433010042,0.003519011243670072
680,"Marion, NC",Micropolitan Statistical Area,"Marion, NC Micro Area",45102,45782,780,4624,5281,-657,168,1313,1481,0.02911179105139462,0.0037248902487694562
681,"Marion, OH",Micropolitan Statistical Area,"Marion, OH Micro Area",66459,64820,-1685,7746,7587,159,342,-2166,-1824,-0.032591522592876815,0.0051460298830858136
682,"Marquette, MI",Micropolitan Statistical Area,"Marquette, MI Micro Area",67080,65834,-1237,6347,6924,-577,409,-1034,-625,-0.0154144305307096,0.006097197376267144
683,"Marshall, MN",Micropolitan Statistical Area,"Marshall, MN Micro Area",25852,25271,-587,3710,2256,1454,1011,-3080,-2069,-0.11913971839702925,0.039107225746557325
684,"Marshall, MO",Micropolitan Statistical Area,"Marshall, MO Micro Area",23422,22858,-514,2841,2606,235,489,-1233,-744,-0.05264281444795491,0.02087780718982153
685,"Marshalltown, IA",Micropolitan Statistical Area,"Marshalltown, IA Micro Area",40722,39495,-1153,5444,4905,539,1255,-2955,-1700,-0.07256519817297775,0.03081872206669613
686,"Martin, TN",Micropolitan Statistical Area,"Martin, TN Micro Area",35044,33334,-1681,3498,3914,-416,272,-1549,-1277,-0.04420157516265266,0.00776167104211848
687,"Martinsville, VA",Micropolitan Statistical Area,"Martinsville, VA Micro Area",67888,62664,-5320,6737,9919,-3182,291,-2397,-2106,-0.035308154607588974,0.004286471835965118
688,"Maryville, MO",Micropolitan Statistical Area,"Maryville, MO Micro Area",23402,21743,-1630,2271,1976,295,157,-2097,-1940,-0.08960772583539868,0.006708828305273053
689,"Mason City, IA",Micropolitan Statistical Area,"Mason City, IA Micro Area",51679,49462,-2280,5598,6090,-492,316,-2087,-1771,-0.04038390835735985,0.006114669401497707
690,"Mayfield, KY",Micropolitan Statistical Area,"Mayfield, KY Micro Area",37254,36818,-324,5129,4661,468,413,-1186,-773,-0.0318355075964997,0.01108605787298008
691,"Maysville, KY",Micropolitan Statistical Area,"Maysville, KY Micro Area",17503,17035,-453,2149,2221,-72,114,-495,-381,-0.02828086613723362,0.006513169170999257
692,"McAlester, OK",Micropolitan Statistical Area,"McAlester, OK Micro Area",45799,43679,-2148,5390,6292,-902,86,-1305,-1219,-0.02849407192296775,0.001877770256992511
693,"McComb, MS",Micropolitan Statistical Area,"McComb, MS Micro Area",40442,38997,-1405,5622,5241,381,49,-1826,-1777,-0.04515108055981405,0.0012116116908164778
694,"McMinnville, TN",Micropolitan Statistical Area,"McMinnville, TN Micro Area",39859,41605,1781,4934,5034,-100,310,1603,1913,0.040216764093429336,0.007777415389247096
695,"McPherson, KS",Micropolitan Statistical Area,"McPherson, KS Micro Area",29128,28448,-738,3301,3799,-498,118,-358,-240,-0.012290579511123318,0.004051084866794836
696,"Meadville, PA",Micropolitan Statistical Area,"Meadville, PA Micro Area",88614,83697,-5053,9510,10355,-845,192,-4366,-4174,-0.049269867063895086,0.002166700521362313
697,"Menomonie, WI",Micropolitan Statistical Area,"Menomonie, WI Micro Area",43888,45452,1587,4547,3403,1144,469,-12,457,-0.0002734232592052497,0.010686292380605178
698,"Meridian, MS",Micropolitan Statistical Area,"Meridian, MS Micro Area",107572,98571,-8871,13040,12115,925,403,-10235,-9832,-0.09514557691592608,0.0037463280407541
699,"Mexico, MO",Micropolitan Statistical Area,"Mexico, MO Micro Area",25453,24835,-696,3444,3092,352,28,-1067,-1039,-0.041920402310140256,0.0011000667897693786
700,"Miami, OK",Micropolitan Statistical Area,"Miami, OK Micro Area",31860,30879,-969,4453,4660,-207,168,-924,-756,-0.029001883239171376,0.005273069679849341
701,"Middlesborough, KY",Micropolitan Statistical Area,"Middlesborough, KY Micro Area",28704,25482,-3206,3492,4022,-530,25,-2708,-2683,-0.0943422519509476,0.000870958751393534
702,"Milledgeville, GA",Micropolitan Statistical Area,"Milledgeville, GA Micro Area",55136,53593,-1648,5261,5529,-268,408,-1899,-1491,-0.03444210679048172,0.007399883923389437
703,"Minden, LA",Micropolitan Statistical Area,"Minden, LA Micro Area",41202,37943,-3263,5006,5451,-445,60,-2880,-2820,-0.06989951944080385,0.0014562399883500802
704,"Mineral Wells, TX",Micropolitan Statistical Area,"Mineral Wells, TX Micro Area",28093,29320,1186,3654,3425,229,108,857,965,0.03050581995514897,0.003844374043355996
705,"Minot, ND",Micropolitan Statistical Area,"Minot, ND Micro Area",70014,76444,6907,12791,5895,6896,2417,-2610,-193,-0.03727825863398749,0.0345216670951524
706,"Mitchell, SD",Micropolitan Statistical Area,"Mitchell, SD Micro Area",22815,23301,465,3071,2425,646,257,-430,-173,-0.018847249616480384,0.011264518956826649
707,"Moberly, MO",Micropolitan Statistical Area,"Moberly, MO Micro Area",25454,24409,-1006,2939,2851,88,46,-1140,-1094,-0.04478667400015714,0.0018071815824624812
708,"Montrose, CO",Micropolitan Statistical Area,"Montrose, CO Micro Area",45639,48323,2609,4835,4715,120,39,2453,2492,0.053747891058086285,0.0008545323078945639
709,"Morehead City, NC",Micropolitan Statistical Area,"Morehead City, NC Micro Area",66700,69558,3095,5919,8271,-2352,621,4836,5457,0.07250374812593703,0.009310344827586206
710,"Morgan City, LA",Micropolitan Statistical Area,"Morgan City, LA Micro Area",54553,48330,-6317,7372,5767,1605,542,-8526,-7984,-0.15628838010741847,0.009935292284567302
711,"Moscow, ID",Micropolitan Statistical Area,"Moscow, ID Micro Area",37258,40830,3587,4455,2293,2162,1542,-106,1436,-0.0028450265714745826,0.04138708465296044
712,"Moses Lake, WA",Micropolitan Statistical Area,"Moses Lake, WA Micro Area",89554,99377,10253,15508,7078,8430,1757,107,1864,0.0011948098354065705,0.01961944748419948
713,"Moultrie, GA",Micropolitan Statistical Area,"Moultrie, GA Micro Area",45638,45542,46,6717,4900,1817,159,-1916,-1757,-0.041982558394320524,0.0034839388229107324
714,"Mountain Home, AR",Micropolitan Statistical Area,"Mountain Home, AR Micro Area",41511,42242,731,3590,6984,-3394,31,4117,4148,0.09917853099178532,0.0007467900074679001
715,"Mountain Home, ID",Micropolitan Statistical Area,"Mountain Home, ID Micro Area",27125,27448,408,4687,1926,2761,1170,-3579,-2409,-0.13194470046082948,0.043133640552995386
716,"Mount Airy, NC",Micropolitan Statistical Area,"Mount Airy, NC Micro Area",73779,71683,-2069,7759,9277,-1518,309,-817,-508,-0.011073611732335759,0.004188183629488066
717,"Mount Gay-Shamrock, WV",Micropolitan Statistical Area,"Mount Gay-Shamrock, WV Micro Area",36719,31688,-5062,3925,5553,-1628,-6,-3449,-3455,-0.09392957324545877,-0.00016340314278711295
718,"Mount Pleasant, MI",Micropolitan Statistical Area,"Mount Pleasant, MI Micro Area",70297,69504,-809,6668,4954,1714,1727,-4299,-2572,-0.06115481457245686,0.02456719347909584
719,"Mount Pleasant, TX",Micropolitan Statistical Area,"Mount Pleasant, TX Micro Area",44813,45986,1253,6899,4300,2599,749,-2098,-1349,-0.04681677191886283,0.016713899984379534
720,"Mount Sterling, KY",Micropolitan Statistical Area,"Mount Sterling, KY Micro Area",44544,47169,2760,6295,5249,1046,-6,1734,1728,0.03892780172413793,-0.00013469827586206896
721,"Mount Vernon, IL",Micropolitan Statistical Area,"Mount Vernon, IL Micro Area",38757,37235,-1590,4822,4641,181,271,-2023,-1752,-0.05219702247335965,0.006992285264597363
722,"Mount Vernon, OH",Micropolitan Statistical Area,"Mount Vernon, OH Micro Area",61087,62423,1497,7523,6335,1188,102,231,333,0.003781491970468349,0.0016697497012457645
723,"Murray, KY",Micropolitan Statistical Area,"Murray, KY Micro Area",37360,39300,2101,3869,4091,-222,1247,1072,2319,0.02869379014989293,0.0333779443254818
724,"Muscatine, IA",Micropolitan Statistical Area,"Muscatine, IA Micro Area",42804,42394,-409,5515,4102,1413,761,-2579,-1818,-0.060251378375852725,0.017778712269881317
725,"Muskogee, OK",Micropolitan Statistical Area,"Muskogee, OK Micro Area",71121,67610,-3381,9190,9485,-295,279,-3353,-3074,-0.04714500639754784,0.003922891972835027
726,"Nacogdoches, TX",Micropolitan Statistical Area,"Nacogdoches, TX Micro Area",64684,64753,229,8761,5903,2858,352,-3006,-2654,-0.04647207964875394,0.005441840331457547
727,"Natchez, MS-LA",Micropolitan Statistical Area,"Natchez, MS-LA Micro Area",53421,49189,-3937,6439,6768,-329,1522,-5173,-3651,-0.09683457816214597,0.028490668463712773
728,"Natchitoches, LA",Micropolitan Statistical Area,"Natchitoches, LA Micro Area",39523,37655,-1908,5203,4109,1094,203,-3188,-2985,-0.0806618930749184,0.005136249778609923
729,"Newberry, SC",Micropolitan Statistical Area,"Newberry, SC Micro Area",37611,38445,935,4448,4478,-30,95,895,990,0.02379622982638058,0.0025258567972135807
730,"New Castle, IN",Micropolitan Statistical Area,"New Castle, IN Micro Area",49530,48033,-1433,4871,5967,-1096,39,-345,-306,-0.006965475469412477,0.0007874015748031496
731,"New Castle, PA",Micropolitan Statistical Area,"New Castle, PA Micro Area",91016,85083,-6073,9058,11829,-2771,284,-3555,-3271,-0.0390590665377516,0.003120330491342181
732,"New Philadelphia-Dover, OH",Micropolitan Statistical Area,"New Philadelphia-Dover, OH Micro Area",92545,91776,-809,11677,10771,906,781,-2443,-1662,-0.0263979685558377,0.008439137716786428
733,"Newport, OR",Micropolitan Statistical Area,"Newport, OR Micro Area",45997,50583,4550,4289,6150,-1861,182,6197,6379,0.13472617779420398,0.0039567797899863035
734,"Newport, TN",Micropolitan Statistical Area,"Newport, TN Micro Area",35641,36225,583,3852,5225,-1373,21,1963,1984,0.05507701804102017,0.0005892090569849331
735,"New Ulm, MN",Micropolitan Statistical Area,"New Ulm, MN Micro Area",25844,24846,-1047,2778,3052,-274,89,-856,-767,-0.033121807769695095,0.003443739359232317
736,"Nogales, AZ",Micropolitan Statistical Area,"Nogales, AZ Micro Area",47402,46808,-609,6591,3036,3555,1081,-5323,-4242,-0.11229483988017384,0.02280494493903211
737,"Norfolk, NE",Micropolitan Statistical Area,"Norfolk, NE Micro Area",48363,47877,-393,6941,4880,2061,743,-3192,-2449,-0.06600086843247938,0.01536298409941484
738,"North Platte, NE",Micropolitan Statistical Area,"North Platte, NE Micro Area",37561,35568,-2022,4471,3874,597,240,-2864,-2624,-0.07624930113681744,0.006389606240515428
739,"North Vernon, IN",Micropolitan Statistical Area,"North Vernon, IN Micro Area",28482,27515,-1014,3406,3055,351,39,-1404,-1365,-0.04929429113124079,0.0013692858647566884
740,"North Wilkesboro, NC",Micropolitan Statistical Area,"North Wilkesboro, NC Micro Area",69265,68043,-1268,6970,8268,-1298,305,-208,97,-0.0030029596477297326,0.004403378329603696
741,"Norwalk, OH",Micropolitan Statistical Area,"Norwalk, OH Micro Area",59566,57979,-1646,7449,6132,1317,187,-3167,-2980,-0.053167914582144184,0.0031393748111338683
742,"Oak Harbor, WA",Micropolitan Statistical Area,"Oak Harbor, WA Micro Area",78700,86014,7506,9310,7357,1953,1745,3794,5539,0.04820838627700127,0.0221728081321474
743,"Ogdensburg-Massena, NY",Micropolitan Statistical Area,"Ogdensburg-Massena, NY Micro Area",111821,107185,-4756,11807,10413,1394,1380,-7559,-6179,-0.06759910929074145,0.012341152377460406
744,"Oil City, PA",Micropolitan Statistical Area,"Oil City, PA Micro Area",54972,50328,-4660,5326,6727,-1401,42,-3288,-3246,-0.059812268063741535,0.0007640253219820999
745,"Okeechobee, FL",Micropolitan Statistical Area,"Okeechobee, FL Micro Area",40014,42297,2310,5430,4519,911,693,716,1409,0.017893737191982804,0.01731893837156995
746,"Olean, NY",Micropolitan Statistical Area,"Olean, NY Micro Area",80220,75863,-4474,9107,8675,432,273,-5193,-4920,-0.06473448017950635,0.0034031413612565444
747,"Oneonta, NY",Micropolitan Statistical Area,"Oneonta, NY Micro Area",62260,58701,-3577,5276,6308,-1032,404,-2936,-2532,-0.047157083199486034,0.006488917442981047
748,"Ontario, OR-ID",Micropolitan Statistical Area,"Ontario, OR-ID Micro Area",53989,55754,1816,7431,5265,2166,-235,-111,-346,-0.0020559743651484557,-0.0043527385208097956
749,"Opelousas, LA",Micropolitan Statistical Area,"Opelousas, LA Micro Area",83503,81440,-1960,12844,10028,2816,90,-4816,-4726,-0.05767457456618325,0.001077805587823192
750,"Orangeburg, SC",Micropolitan Statistical Area,"Orangeburg, SC Micro Area",92323,85343,-7165,10609,11007,-398,333,-7113,-6780,-0.07704472341670006,0.0036069018554423064
751,"Oskaloosa, IA",Micropolitan Statistical Area,"Oskaloosa, IA Micro Area",22409,22370,-14,2838,2384,454,303,-760,-457,-0.03391494488821456,0.01352135302780133
752,"Othello, WA",Micropolitan Statistical Area,"Othello, WA Micro Area",18791,20027,1296,4031,1230,2801,271,-1788,-1517,-0.09515193443669842,0.01442179766909691
753,"Ottawa, IL",Micropolitan Statistical Area,"Ottawa, IL Micro Area",154785,145590,-9309,15972,17944,-1972,513,-7838,-7325,-0.050637981716574604,0.003314274639015409
754,"Ottawa, KS",Micropolitan Statistical Area,"Ottawa, KS Micro Area",25986,25703,-291,3194,2677,517,146,-952,-806,-0.03663511121373047,0.005618409913030093
755,"Ottumwa, IA",Micropolitan Statistical Area,"Ottumwa, IA Micro Area",35679,34985,-637,4495,4212,283,1230,-2131,-901,-0.05972701028616272,0.03447406037164718
756,"Owatonna, MN",Micropolitan Statistical Area,"Owatonna, MN Micro Area",36497,36596,15,4577,3161,1416,71,-1479,-1408,-0.04052387867495959,0.0019453653724963696
757,"Oxford, MS",Micropolitan Statistical Area,"Oxford, MS Micro Area",47574,54408,7047,5575,3908,1667,551,4678,5229,0.09833102114600413,0.011581956530878209
758,"Ozark, AL",Micropolitan Statistical Area,"Ozark, AL Micro Area",50396,48959,-1294,6790,5262,1528,812,-3640,-2828,-0.07222795459957139,0.01611238987221208
759,"Paducah, KY-IL",Micropolitan Statistical Area,"Paducah, KY-IL Micro Area",98673,96090,-2642,11341,12829,-1488,114,-1203,-1089,-0.012191784986774498,0.0011553312456295036
760,"Pahrump, NV",Micropolitan Statistical Area,"Pahrump, NV Micro Area",43848,48054,4110,3882,7389,-3507,-190,7810,7620,0.17811530742565224,-0.004333150884875022
761,"Palatka, FL",Micropolitan Statistical Area,"Palatka, FL Micro Area",74223,74815,435,8544,10141,-1597,139,1939,2078,0.02612397774274821,0.0018727348665508
762,"Palestine, TX",Micropolitan Statistical Area,"Palestine, TX Micro Area",58498,57805,-652,6125,6814,-689,409,-346,63,-0.005914732127594106,0.006991692023658929
763,"Pampa, TX",Micropolitan Statistical Area,"Pampa, TX Micro Area",23394,22471,-991,3208,2768,440,57,-1517,-1460,-0.06484568692827221,0.002436522185175686
764,"Paragould, AR",Micropolitan Statistical Area,"Paragould, AR Micro Area",42202,45597,3507,5773,4984,789,46,2670,2716,0.06326714373726364,0.0010899957347992985
765,"Paris, TN",Micropolitan Statistical Area,"Paris, TN Micro Area",32396,32056,-293,3363,4791,-1428,36,1126,1162,0.034757377454006665,0.0011112483022595384
766,"Paris, TX",Micropolitan Statistical Area,"Paris, TX Micro Area",49822,49905,114,6699,6414,285,101,-257,-156,-0.00515836377503914,0.002027216892136004
767,"Parsons, KS",Micropolitan Statistical Area,"Parsons, KS Micro Area",21536,19586,-2023,2743,2698,45,34,-2115,-2081,-0.09820765230312037,0.0015787518573551265
768,"Payson, AZ",Micropolitan Statistical Area,"Payson, AZ Micro Area",53565,54303,711,5917,7887,-1970,257,2467,2724,0.04605619340987585,0.004797909082423224
769,"Pearsall, TX",Micropolitan Statistical Area,"Pearsall, TX Micro Area",17255,20379,3162,2584,1412,1172,1895,78,1973,0.004520428861199652,0.10982323964068386
770,"Pecos, TX",Micropolitan Statistical Area,"Pecos, TX Micro Area",13914,16130,2265,1921,1121,800,630,798,1428,0.05735230702889176,0.04527813712807245
771,"Pella, IA",Micropolitan Statistical Area,"Pella, IA Micro Area",33225,33168,-139,3717,3490,227,123,-483,-360,-0.0145372460496614,0.003702031602708804
772,"Peru, IN",Micropolitan Statistical Area,"Peru, IN Micro Area",36810,35328,-1577,3776,3797,-21,191,-1756,-1565,-0.04770442814452595,0.005188807389296387
773,"Picayune, MS",Micropolitan Statistical Area,"Picayune, MS Micro Area",55683,55876,150,6500,6629,-129,-109,406,297,0.007291273817861825,-0.0019575094732683226
774,"Pierre, SD",Micropolitan Statistical Area,"Pierre, SD Micro Area",20049,20457,469,2797,1743,1054,1,-583,-582,-0.029078757045239163,4.987779939149085e-05
775,"Pinehurst-Southern Pines, NC",Micropolitan Statistical Area,"Pinehurst-Southern Pines, NC Micro Area",88595,103352,15102,10874,11355,-481,920,14592,15512,0.16470455443309442,0.01038433320164795
776,"Pittsburg, KS",Micropolitan Statistical Area,"Pittsburg, KS Micro Area",39173,38730,-405,4903,4269,634,989,-2020,-1031,-0.05156612973221352,0.02524698133918771
777,"Plainview, TX",Micropolitan Statistical Area,"Plainview, TX Micro Area",36271,32754,-3453,4941,3179,1762,40,-5325,-5285,-0.14681150230211465,0.0011028094069642411
778,"Platteville, WI",Micropolitan Statistical Area,"Platteville, WI Micro Area",51234,51021,-183,5700,5077,623,280,-1104,-824,-0.0215481906546434,0.00546512081820666
779,"Plattsburgh, NY",Micropolitan Statistical Area,"Plattsburgh, NY Micro Area",82099,79778,-2353,7772,7353,419,871,-3639,-2768,-0.04432453501260673,0.010609142620494769
780,"Plymouth, IN",Micropolitan Statistical Area,"Plymouth, IN Micro Area",47000,46108,-942,5868,4760,1108,307,-2358,-2051,-0.05017021276595745,0.006531914893617021
781,"Point Pleasant, WV-OH",Micropolitan Statistical Area,"Point Pleasant, WV-OH Micro Area",58443,56137,-2158,6618,7437,-819,232,-1559,-1327,-0.02667556422497134,0.0039696798590079215
782,"Ponca City, OK",Micropolitan Statistical Area,"Ponca City, OK Micro Area",46428,43274,-3288,6119,5984,135,94,-3512,-3418,-0.0756440079262514,0.0020246403032652713
783,"Pontiac, IL",Micropolitan Statistical Area,"Pontiac, IL Micro Area",38862,35414,-3537,4301,4386,-85,174,-3688,-3514,-0.09489990221810507,0.0044773815037826145
784,"Poplar Bluff, MO",Micropolitan Statistical Area,"Poplar Bluff, MO Micro Area",56887,55478,-1420,7329,7819,-490,16,-893,-877,-0.015697786840578692,0.00028125933868897987
785,"Portales, NM",Micropolitan Statistical Area,"Portales, NM Micro Area",20020,18350,-1490,2843,1598,1245,426,-3216,-2790,-0.16063936063936066,0.021278721278721283
786,"Port Angeles, WA",Micropolitan Statistical Area,"Port Angeles, WA Micro Area",71505,78067,6671,6677,10155,-3478,752,9396,10148,0.13140339836375078,0.010516747080623732
787,"Port Lavaca, TX",Micropolitan Statistical Area,"Port Lavaca, TX Micro Area",21312,21001,-379,2925,2134,791,319,-1482,-1163,-0.06953828828828829,0.01496809309309309
788,"Portsmouth, OH",Micropolitan Statistical Area,"Portsmouth, OH Micro Area",79672,74347,-5312,8897,10176,-1279,257,-4296,-4039,-0.053921076413294515,0.003225725474445225
789,"Pottsville, PA",Micropolitan Statistical Area,"Pottsville, PA Micro Area",148280,140709,-7572,14070,19867,-5797,406,-2084,-1678,-0.014054491502562721,0.0027380631238198005
790,"Price, UT",Micropolitan Statistical Area,"Price, UT Micro Area",21403,20760,-643,2825,2270,555,125,-1343,-1218,-0.06274821286735505,0.005840302761295145
791,"Prineville, OR",Micropolitan Statistical Area,"Prineville, OR Micro Area",20882,25105,4127,2188,2556,-368,-42,4516,4474,0.21626281007566325,-0.0020113015994636533
792,"Pullman, WA",Micropolitan Statistical Area,"Pullman, WA Micro Area",44795,49500,4722,4297,2727,1570,4141,-1078,3063,-0.024065185846634668,0.09244335305279608
793,"Quincy, IL-MO",Micropolitan Statistical Area,"Quincy, IL-MO Micro Area",77364,74593,-2707,9458,9440,18,253,-2944,-2691,-0.038053875187425666,0.003270254898919394
794,"Raymondville, TX",Micropolitan Statistical Area,"Raymondville, TX Micro Area",22226,21161,-976,2969,1751,1218,69,-2275,-2206,-0.1023575992081346,0.0031044722397192475
795,"Red Bluff, CA",Micropolitan Statistical Area,"Red Bluff, CA Micro Area",63562,64494,1053,7821,6703,1118,-210,192,-18,0.003020672728989019,-0.0033038607973317393
796,"Red Wing, MN",Micropolitan Statistical Area,"Red Wing, MN Micro Area",46225,46318,124,5262,4997,265,151,-265,-114,-0.005732828555976203,0.003266630611141157
797,"Rexburg, ID",Micropolitan Statistical Area,"Rexburg, ID Micro Area",50820,53536,2751,13158,2488,10670,602,-8597,-7995,-0.16916568280204644,0.011845730027548207
798,"Richmond, IN",Micropolitan Statistical Area,"Richmond, IN Micro Area",68897,65778,-3218,8043,8897,-854,542,-2892,-2350,-0.0419757028607922,0.00786681568137945
799,"Richmond-Berea, KY",Micropolitan Statistical Area,"Richmond-Berea, KY Micro Area",98193,108374,10778,11823,9681,2142,816,7746,8562,0.07888546026702514,0.008310164675689713
800,"Rio Grande City-Roma, TX",Micropolitan Statistical Area,"Rio Grande City-Roma, TX Micro Area",61140,64266,3284,13176,4055,9121,348,-6218,-5870,-0.10170101406607786,0.005691854759568204
801,"Riverton, WY",Micropolitan Statistical Area,"Riverton, WY Micro Area",40199,39317,-806,5770,4498,1272,-3,-2097,-2100,-0.05216547675315306,-7.462872210751512e-05
802,"Roanoke Rapids, NC",Micropolitan Statistical Area,"Roanoke Rapids, NC Micro Area",76513,68567,-8168,7703,9745,-2042,248,-6391,-6143,-0.08352828931031328,0.0032412792597336397
803,"Rochelle, IL",Micropolitan Statistical Area,"Rochelle, IL Micro Area",53420,50306,-3188,5454,5165,289,179,-3687,-3508,-0.06901909397229503,0.0033508049419693
804,"Rockingham, NC",Micropolitan Statistical Area,"Rockingham, NC Micro Area",46636,44332,-2315,5644,5743,-99,25,-2233,-2208,-0.04788146496268977,0.0005360665580238441
805,"Rockport, TX",Micropolitan Statistical Area,"Rockport, TX Micro Area",23189,23814,649,2520,3557,-1037,11,1615,1626,0.06964509034455993,0.0004743628444521108
806,"Rock Springs, WY",Micropolitan Statistical Area,"Rock Springs, WY Micro Area",43580,42673,-1133,6007,2982,3025,476,-4718,-4242,-0.10826067003212483,0.010922441486920606
807,"Rolla, MO",Micropolitan Statistical Area,"Rolla, MO Micro Area",45298,44414,-711,5171,4610,561,1971,-3272,-1301,-0.07223276965870458,0.043511854828027725
808,"Roseburg, OR",Micropolitan Statistical Area,"Roseburg, OR Micro Area",107637,111364,3680,11047,14929,-3882,178,7484,7662,0.06952999433280377,0.001653706439235579
809,"Roswell, NM",Micropolitan Statistical Area,"Roswell, NM Micro Area",65721,64711,-937,9148,6798,2350,681,-3950,-3269,-0.06010255473897232,0.010361984753731684
810,"Ruidoso, NM",Micropolitan Statistical Area,"Ruidoso, NM Micro Area",20451,19939,-554,1863,2169,-306,260,-510,-250,-0.024937655860349132,0.012713314752334849
811,"Russellville, AR",Micropolitan Statistical Area,"Russellville, AR Micro Area",84258,85515,1576,10913,8749,2164,800,-1381,-581,-0.016390135061359157,0.00949464739253246
812,"Ruston, LA",Micropolitan Statistical Area,"Ruston, LA Micro Area",46854,46552,-188,5731,3931,1800,1334,-3328,-1994,-0.07102915439450208,0.028471421863661587
813,"Rutland, VT",Micropolitan Statistical Area,"Rutland, VT Micro Area",61585,57764,-3895,5327,7037,-1710,110,-2285,-2175,-0.03710319071202403,0.0017861492246488593
814,"Safford, AZ",Micropolitan Statistical Area,"Safford, AZ Micro Area",37154,39211,1999,5677,2970,2707,436,-1172,-736,-0.03154438283899445,0.011734941056144695
815,"St. Marys, GA",Micropolitan Statistical Area,"St. Marys, GA Micro Area",50680,55388,4863,8042,3543,4499,865,-523,342,-0.010319652722967641,0.01706787687450671
816,"St. Marys, PA",Micropolitan Statistical Area,"St. Marys, PA Micro Area",31862,29607,-2339,3025,4005,-980,13,-1367,-1354,-0.04290377251898814,0.000408009541146193
817,"Salem, OH",Micropolitan Statistical Area,"Salem, OH Micro Area",107889,101118,-6732,10888,12831,-1943,309,-5074,-4765,-0.04702981768298901,0.002864054722909657
818,"Salina, KS",Micropolitan Statistical Area,"Salina, KS Micro Area",61878,59638,-2057,7947,6241,1706,189,-3932,-3743,-0.06354439380716895,0.0030543973625521193
819,"Sandpoint, ID",Micropolitan Statistical Area,"Sandpoint, ID Micro Area",40904,46817,5940,4169,4430,-261,101,6085,6186,0.14876295716800314,0.0024691961666340697
820,"Sandusky, OH",Micropolitan Statistical Area,"Sandusky, OH Micro Area",76977,73719,-3344,8037,9666,-1629,233,-1904,-1671,-0.024734661002637152,0.003026878158410954
821,"Sanford, NC",Micropolitan Statistical Area,"Sanford, NC Micro Area",57879,62353,4504,8129,5861,2268,711,1539,2250,0.026589954905924428,0.012284248172912456
822,"Sault Ste. Marie, MI",Micropolitan Statistical Area,"Sault Ste. Marie, MI Micro Area",38623,36958,-1718,3497,3779,-282,290,-1743,-1453,-0.045128550345648964,0.007508479403464256
823,"Sayre, PA",Micropolitan Statistical Area,"Sayre, PA Micro Area",62731,60221,-2479,7244,7167,77,254,-2810,-2556,-0.04479443975068148,0.004049034767499323
824,"Scottsbluff, NE",Micropolitan Statistical Area,"Scottsbluff, NE Micro Area",39060,37285,-1688,5069,4420,649,212,-2552,-2340,-0.06533538146441373,0.005427547363031234
825,"Scottsboro, AL",Micropolitan Statistical Area,"Scottsboro, AL Micro Area",53207,51582,-1666,5805,7135,-1330,151,-448,-297,-0.008419944744112617,0.0028379724472343865
826,"Scottsburg, IN",Micropolitan Statistical Area,"Scottsburg, IN Micro Area",24172,23788,-407,2855,3198,-343,130,-189,-59,-0.007818964090683436,0.005378123448618236
827,"Searcy, AR",Micropolitan Statistical Area,"Searcy, AR Micro Area",77349,78729,1654,9778,8564,1214,467,-18,449,-0.00023271147655431874,0.006037569975048158
828,"Sedalia, MO",Micropolitan Statistical Area,"Sedalia, MO Micro Area",42263,42490,289,6000,4510,1490,424,-1602,-1178,-0.037905496533610965,0.010032416061330242
829,"Selinsgrove, PA",Micropolitan Statistical Area,"Selinsgrove, PA Micro Area",39709,40317,598,4314,3679,635,175,-177,-2,-0.004457427787151527,0.0044070613714774975
830,"Selma, AL",Micropolitan Statistical Area,"Selma, AL Micro Area",43855,36098,-7715,5148,5519,-371,50,-7431,-7381,-0.16944476114468135,0.0011401208528103981
831,"Seneca, SC",Micropolitan Statistical Area,"Seneca, SC Micro Area",74349,80015,5730,7754,9219,-1465,1008,6195,7203,0.08332324577331235,0.013557680668199977
832,"Seneca Falls, NY",Micropolitan Statistical Area,"Seneca Falls, NY Micro Area",35271,33991,-1262,3844,3556,288,198,-1741,-1543,-0.04936066456862578,0.005613676958407757
833,"Sevierville, TN",Micropolitan Statistical Area,"Sevierville, TN Micro Area",89921,99244,9532,10740,10470,270,1809,7414,9223,0.08245015068782598,0.020117658833865282
834,"Seymour, IN",Micropolitan Statistical Area,"Seymour, IN Micro Area",42584,44222,1846,6072,4772,1300,901,-339,562,-0.007960736426826978,0.021158181476610933
835,"Shawano, WI",Micropolitan Statistical Area,"Shawano, WI Micro Area",46208,45332,-855,5400,5253,147,177,-1159,-982,-0.02508223684210526,0.003830505540166205
836,"Shawnee, OK",Micropolitan Statistical Area,"Shawnee, OK Micro Area",69653,72998,3551,9231,8495,736,326,2514,2840,0.03609320488708311,0.004680343990926449
837,"Shelby, NC",Micropolitan Statistical Area,"Shelby, NC Micro Area",97922,99035,1001,11203,12320,-1117,546,1655,2201,0.01690120708318866,0.005575866505994567
838,"Shelbyville, TN",Micropolitan Statistical Area,"Shelbyville, TN Micro Area",45082,50179,5121,6536,4917,1619,638,2865,3503,0.06355086287209973,0.014151989707643847
839,"Shelton, WA",Micropolitan Statistical Area,"Shelton, WA Micro Area",60733,68224,7535,6518,6853,-335,1203,6697,7900,0.11026954044753264,0.01980801211861756
840,"Sheridan, WY",Micropolitan Statistical Area,"Sheridan, WY Micro Area",29148,30863,1739,3301,3261,40,325,1388,1713,0.047619047619047616,0.01114999313846576
841,"Show Low, AZ",Micropolitan Statistical Area,"Show Low, AZ Micro Area",107693,112112,4624,15776,10400,5376,682,-1405,-723,-0.013046344702069772,0.0063328164318943655
842,"Sidney, OH",Micropolitan Statistical Area,"Sidney, OH Micro Area",49347,48337,-1118,6300,4638,1662,586,-3387,-2801,-0.06863639126998601,0.011875088657871806
843,"Sikeston, MO",Micropolitan Statistical Area,"Sikeston, MO Micro Area",39268,38288,-916,5159,4500,659,61,-1615,-1554,-0.04112763573393094,0.001553427727411633
844,"Silver City, NM",Micropolitan Statistical Area,"Silver City, NM Micro Area",29386,27007,-2505,2971,3545,-574,127,-2044,-1917,-0.06955693187232015,0.004321785884434765
845,"Snyder, TX",Micropolitan Statistical Area,"Snyder, TX Micro Area",16929,16662,-257,2430,1798,632,129,-1023,-894,-0.06042884990253411,0.007620060251639199
846,"Somerset, KY",Micropolitan Statistical Area,"Somerset, KY Micro Area",63195,65530,2468,7683,8281,-598,321,2800,3121,0.04430730279294248,0.0050795157844766205
847,"Somerset, PA",Micropolitan Statistical Area,"Somerset, PA Micro Area",77763,72916,-4820,7082,9955,-2873,301,-2191,-1890,-0.028175353317130256,0.003870735439733549
848,"Sonora, CA",Micropolitan Statistical Area,"Sonora, CA Micro Area",55164,54515,-829,4727,6688,-1961,323,828,1151,0.015009788992821403,0.0058552679283590744
849,"Spearfish, SD",Micropolitan Statistical Area,"Spearfish, SD Micro Area",24204,26221,2131,2345,2352,-7,535,1582,2117,0.06536109733928276,0.02210378449843001
850,"Spencer, IA",Micropolitan Statistical Area,"Spencer, IA Micro Area",16633,15976,-691,2007,1962,45,71,-800,-729,-0.04809715625563638,0.004268622617687729
851,"Spirit Lake, IA",Micropolitan Statistical Area,"Spirit Lake, IA Micro Area",16669,17549,882,1631,2053,-422,128,1192,1320,0.07150998860159577,0.007678924950506929
852,"Starkville, MS",Micropolitan Statistical Area,"Starkville, MS Micro Area",57992,59465,1545,6926,4626,2300,1045,-1841,-796,-0.03174575803559112,0.018019726858877087
853,"Statesboro, GA",Micropolitan Statistical Area,"Statesboro, GA Micro Area",70560,80839,10595,8954,5414,3540,1194,5755,6949,0.08156179138321995,0.01692176870748299
854,"Steamboat Springs, CO",Micropolitan Statistical Area,"Steamboat Springs, CO Micro Area",23434,25560,2054,2205,1121,1084,524,418,942,0.017837330374669284,0.02236067252709738
855,"Stephenville, TX",Micropolitan Statistical Area,"Stephenville, TX Micro Area",37913,43224,5329,4960,3421,1539,120,3635,3755,0.09587740352913247,0.0031651412444280327
856,"Sterling, CO",Micropolitan Statistical Area,"Sterling, CO Micro Area",22749,21974,-735,2336,2131,205,31,-977,-946,-0.04294694272275704,0.0013626972614180846
857,"Sterling, IL",Micropolitan Statistical Area,"Sterling, IL Micro Area",58489,54656,-3849,6432,6721,-289,70,-3630,-3560,-0.0620629520080699,0.0011968062370702186
858,"Stevens Point, WI",Micropolitan Statistical Area,"Stevens Point, WI Micro Area",70025,71032,1011,6997,5442,1555,1160,-1671,-511,-0.023862906104962514,0.016565512317029633
859,"Stillwater, OK",Micropolitan Statistical Area,"Stillwater, OK Micro Area",77420,81755,4408,9032,5900,3132,4362,-3067,1295,-0.03961508654094549,0.056342030483079314
860,"Storm Lake, IA",Micropolitan Statistical Area,"Storm Lake, IA Micro Area",20356,19772,-493,3172,1858,1314,900,-2717,-1817,-0.13347415995283946,0.04421300844959717
861,"Sturgis, MI",Micropolitan Statistical Area,"Sturgis, MI Micro Area",61288,60848,-455,8112,6546,1566,338,-2344,-2006,-0.03824565983553061,0.005514945829526171
862,"Sulphur Springs, TX",Micropolitan Statistical Area,"Sulphur Springs, TX Micro Area",35211,37170,2004,4720,4056,664,-49,1400,1351,0.03976030217829656,-0.0013916105762403796
863,"Summerville, GA",Micropolitan Statistical Area,"Summerville, GA Micro Area",25958,24843,-1179,2991,3273,-282,65,-970,-905,-0.037368056090607914,0.0025040449957623853
864,"Sunbury, PA",Micropolitan Statistical Area,"Sunbury, PA Micro Area",94287,90258,-4210,9617,12087,-2470,315,-1993,-1678,-0.021137590548007682,0.003340863533679086
865,"Susanville, CA",Micropolitan Statistical Area,"Susanville, CA Micro Area",34828,30016,-4879,3095,2302,793,110,-5902,-5792,-0.16946135293442058,0.003158378316297232
866,"Sweetwater, TX",Micropolitan Statistical Area,"Sweetwater, TX Micro Area",15247,14835,-379,2058,1823,235,245,-863,-618,-0.0566012986161212,0.016068734833081917
867,"Tahlequah, OK",Micropolitan Statistical Area,"Tahlequah, OK Micro Area",47126,49019,2027,6089,5202,887,474,682,1156,0.014471841446335357,0.010058142002291728
868,"Talladega-Sylacauga, AL",Micropolitan Statistical Area,"Talladega-Sylacauga, AL Micro Area",82175,79985,-2363,8850,10320,-1470,408,-1266,-858,-0.015406145421356859,0.004965013690295102
869,"Taos, NM",Micropolitan Statistical Area,"Taos, NM Micro Area",32897,32593,-340,2980,3065,-85,221,-452,-231,-0.013739854697996778,0.006717937805878957
870,"Taylorville, IL",Micropolitan Statistical Area,"Taylorville, IL Micro Area",34767,32075,-2722,3552,4228,-676,87,-2130,-2043,-0.06126499266545862,0.002502372939856761
871,"The Dalles, OR",Micropolitan Statistical Area,"The Dalles, OR Micro Area",25282,26403,1192,3090,3205,-115,48,1265,1313,0.050035598449489765,0.0018985839727869629
872,"Thomaston, GA",Micropolitan Statistical Area,"Thomaston, GA Micro Area",27052,26527,-620,3297,3852,-555,24,-87,-63,-0.003216028389767855,0.0008871802454532012
873,"Thomasville, GA",Micropolitan Statistical Area,"Thomasville, GA Micro Area",44744,44372,-347,5754,5307,447,182,-950,-768,-0.0212318970141248,0.004067584480600751
874,"Tiffin, OH",Micropolitan Statistical Area,"Tiffin, OH Micro Area",56619,54938,-1805,6008,6142,-134,586,-2253,-1667,-0.039792295872410316,0.010349882548261184
875,"Tifton, GA",Micropolitan Statistical Area,"Tifton, GA Micro Area",40250,40719,587,5743,4227,1516,66,-1044,-978,-0.025937888198757763,0.0016397515527950312
876,"Toccoa, GA",Micropolitan Statistical Area,"Toccoa, GA Micro Area",26124,26107,-55,3157,3619,-462,41,378,419,0.014469453376205787,0.0015694380646149135
877,"Torrington, CT",Micropolitan Statistical Area,"Torrington, CT Micro Area",189762,179610,-10266,14714,18539,-3825,2479,-8913,-6434,-0.04696936162139944,0.013063732464877057
878,"Traverse City, MI",Micropolitan Statistical Area,"Traverse City, MI Micro Area",143334,151190,7825,14393,15339,-946,486,8316,8802,0.0580183347984428,0.0033906819038050985
879,"Troy, AL",Micropolitan Statistical Area,"Troy, AL Micro Area",32972,32966,64,3833,3352,481,1161,-1613,-452,-0.04892029600873468,0.03521169477132112
880,"Truckee-Grass Valley, CA",Micropolitan Statistical Area,"Truckee-Grass Valley, CA Micro Area",98795,99606,857,8242,10248,-2006,139,2816,2955,0.028503466774634344,0.0014069537932081585
881,"Tullahoma-Manchester, TN",Micropolitan Statistical Area,"Tullahoma-Manchester, TN Micro Area",100063,106555,6343,11553,12658,-1105,470,7023,7493,0.07018578295673726,0.004697040864255519
882,"Tupelo, MS",Micropolitan Statistical Area,"Tupelo, MS Micro Area",161582,166201,4661,22198,18389,3809,703,201,904,0.00124395044002426,0.004350732136005247
883,"Ukiah, CA",Micropolitan Statistical Area,"Ukiah, CA Micro Area",87796,86061,-1789,10379,8825,1554,13,-3288,-3275,-0.03745045332361383,0.0001480705271310766
884,"Union, SC",Micropolitan Statistical Area,"Union, SC Micro Area",28914,26991,-1965,3129,3976,-847,-11,-1103,-1114,-0.03814761015425053,-0.00038043854188282494
885,"Union City, TN",Micropolitan Statistical Area,"Union City, TN Micro Area",31822,30131,-1676,3567,4022,-455,69,-1289,-1220,-0.040506567783294575,0.0021683112312236817
886,"Urbana, OH",Micropolitan Statistical Area,"Urbana, OH Micro Area",40078,38960,-1141,4130,4110,20,106,-1270,-1164,-0.0316882079944109,0.002644842557013823
887,"Uvalde, TX",Micropolitan Statistical Area,"Uvalde, TX Micro Area",26441,26742,339,4087,2581,1506,234,-1379,-1145,-0.05215385197231572,0.008849892212851256
888,"Van Wert, OH",Micropolitan Statistical Area,"Van Wert, OH Micro Area",28679,28159,-600,3440,3258,182,94,-868,-774,-0.03026604832804491,0.0032776596115624674
889,"Vermillion, SD",Micropolitan Statistical Area,"Vermillion, SD Micro Area",13830,14246,380,1481,1018,463,315,-408,-93,-0.02950108459869848,0.0227765726681128
890,"Vernal, UT",Micropolitan Statistical Area,"Vernal, UT Micro Area",32465,35970,3381,6509,2373,4136,141,-988,-847,-0.030432773756352994,0.004343138764823657
891,"Vernon, TX",Micropolitan Statistical Area,"Vernon, TX Micro Area",13509,12552,-983,1690,1607,83,87,-1166,-1079,-0.08631282848471389,0.006440151010437486
892,"Vicksburg, MS",Micropolitan Statistical Area,"Vicksburg, MS Micro Area",48833,44841,-3929,6241,5342,899,257,-5081,-4824,-0.10404849179857883,0.00526283455859767
893,"Vidalia, GA",Micropolitan Statistical Area,"Vidalia, GA Micro Area",36388,35985,-366,4983,4089,894,7,-1262,-1255,-0.03468176321864351,0.00019237111135539186
894,"Vincennes, IN",Micropolitan Statistical Area,"Vincennes, IN Micro Area",38394,36522,-1918,4560,4531,29,147,-2098,-1951,-0.05464395478460176,0.0038287232380059375
895,"Vineyard Haven, MA",Micropolitan Statistical Area,"Vineyard Haven, MA Micro Area",16573,17461,926,1681,1483,198,212,517,729,0.031195317685391907,0.012791890424183914
896,"Wabash, IN",Micropolitan Statistical Area,"Wabash, IN Micro Area",32850,30784,-2104,3429,4359,-930,96,-1265,-1169,-0.038508371385083714,0.0029223744292237444
897,"Wahpeton, ND-MN",Micropolitan Statistical Area,"Wahpeton, ND-MN Micro Area",22920,22317,-580,2606,2234,372,21,-966,-945,-0.042146596858638745,0.0009162303664921467
898,"Wapakoneta, OH",Micropolitan Statistical Area,"Wapakoneta, OH Micro Area",45914,45680,-253,5630,5007,623,244,-1111,-867,-0.024197412553905128,0.005314283225160082
899,"Warren, PA",Micropolitan Statistical Area,"Warren, PA Micro Area",41770,38911,-2900,4103,5245,-1142,95,-1834,-1739,-0.043907110366291593,0.0022743595882212114
900,"Warrensburg, MO",Micropolitan Statistical Area,"Warrensburg, MO Micro Area",52689,54219,1654,7316,4155,3161,1110,-2640,-1530,-0.05010533507942835,0.02106701588566873
901,"Warsaw, IN",Micropolitan Statistical Area,"Warsaw, IN Micro Area",77338,78988,1633,10479,7262,3217,746,-2270,-1524,-0.029351677053970883,0.009645969639763118
902,"Washington, IN",Micropolitan Statistical Area,"Washington, IN Micro Area",31721,33505,1851,5572,3461,2111,149,-391,-242,-0.012326219223858013,0.004697203745153054
903,"Washington, NC",Micropolitan Statistical Area,"Washington, NC Micro Area",47826,47073,-711,4794,6063,-1269,141,456,597,0.009534562790114163,0.002948187178522143
904,"Washington Court House, OH",Micropolitan Statistical Area,"Washington Court House, OH Micro Area",29016,28579,-455,3515,3701,-186,158,-410,-252,-0.014130135097877031,0.005445271574303833
905,"Watertown, SD",Micropolitan Statistical Area,"Watertown, SD Micro Area",33127,34420,1296,4906,3196,1710,489,-893,-404,-0.0269568629818577,0.014761372898240106
906,"Watertown-Fort Atkinson, WI",Micropolitan Statistical Area,"Watertown-Fort Atkinson, WI Micro Area",83727,85038,1346,8806,6899,1907,319,-833,-514,-0.00994900091965555,0.0038100015526652095
907,"Wauchula, FL",Micropolitan Statistical Area,"Wauchula, FL Micro Area",27731,26822,-915,3861,2188,1673,362,-2978,-2616,-0.10738884281129422,0.013053982907215751
908,"Waycross, GA",Micropolitan Statistical Area,"Waycross, GA Micro Area",55121,55348,290,7513,6839,674,76,-462,-386,-0.008381560566753142,0.0013787848551368807
909,"Weatherford, OK",Micropolitan Statistical Area,"Weatherford, OK Micro Area",27583,28648,1106,4470,3019,1451,433,-806,-373,-0.029220896929268023,0.01569807490120726
910,"West Plains, MO",Micropolitan Statistical Area,"West Plains, MO Micro Area",40544,40262,-116,5216,5241,-25,97,-161,-64,-0.003970994475138122,0.002392462509865825
911,"West Point, MS",Micropolitan Statistical Area,"West Point, MS Micro Area",20569,19352,-1306,2349,2406,-57,39,-1286,-1247,-0.06252126987213769,0.0018960571734163059
912,"Whitewater, WI",Micropolitan Statistical Area,"Whitewater, WI Micro Area",102195,103953,1731,10261,9515,746,127,914,1041,0.00894368609031753,0.0012427222466852585
913,"Williston, ND",Micropolitan Statistical Area,"Williston, ND Micro Area",22591,38700,16301,6442,2370,4072,417,11424,11841,0.5056881058828737,0.01845867823469523
914,"Willmar, MN",Micropolitan Statistical Area,"Willmar, MN Micro Area",42231,43130,893,5912,3989,1923,1792,-2819,-1027,-0.06675191210248396,0.04243328360682911
915,"Wilmington, OH",Micropolitan Statistical Area,"Wilmington, OH Micro Area",41922,41921,-125,5067,4597,470,195,-780,-585,-0.018605982539001,0.00465149563475025
916,"Wilson, NC",Micropolitan Statistical Area,"Wilson, NC Micro Area",81294,81979,754,9878,8909,969,710,-870,-160,-0.010701896818953428,0.008733731886732108
917,"Winfield, KS",Micropolitan Statistical Area,"Winfield, KS Micro Area",36314,34628,-1681,4400,4436,-36,347,-1996,-1649,-0.05496502726221292,0.009555543316627195
918,"Winnemucca, NV",Micropolitan Statistical Area,"Winnemucca, NV Micro Area",16580,16962,443,2594,1295,1299,57,-945,-888,-0.056996381182147164,0.0034378769601930035
919,"Winona, MN",Micropolitan Statistical Area,"Winona, MN Micro Area",51432,50485,-976,4822,4258,564,673,-2223,-1550,-0.04322211852543164,0.01308523876186032
920,"Wisconsin Rapids-Marshfield, WI",Micropolitan Statistical Area,"Wisconsin Rapids-Marshfield, WI Micro Area",74812,72560,-2190,8398,8139,259,238,-2681,-2443,-0.03583649681869218,0.0031813078115810298
921,"Woodward, OK",Micropolitan Statistical Area,"Woodward, OK Micro Area",24154,23642,-593,3425,2635,790,323,-1742,-1419,-0.0721205597416577,0.013372526289641468
922,"Wooster, OH",Micropolitan Statistical Area,"Wooster, OH Micro Area",114409,115694,1163,15523,11499,4024,1003,-3818,-2815,-0.03337150049384227,0.008766792822243005
923,"Worthington, MN",Micropolitan Statistical Area,"Worthington, MN Micro Area",21424,21400,22,3797,1828,1969,1436,-3407,-1971,-0.15902725914861834,0.06702763256161315
924,"Yankton, SD",Micropolitan Statistical Area,"Yankton, SD Micro Area",22436,22742,304,2729,2363,366,102,-146,-44,-0.006507398823319665,0.004546264931360314
925,"Zanesville, OH",Micropolitan Statistical Area,"Zanesville, OH Micro Area",86213,86020,-66,10486,10090,396,509,-922,-413,-0.010694442833447393,0.005903981998074536
926,"Zapata, TX",Micropolitan Statistical Area,"Zapata, TX Micro Area",14086,14172,154,2692,951,1741,35,-1629,-1594,-0.1156467414454068,0.002484736617918501
