,name,geo_type,popestimate2010,popestimate2020,n_pop_chg_2010_2020,births_2010_2020,deaths_2010_2020,natural_increase_2010_2020,int_migration_2010_2020,dom_migration_2010_2020,net_migration_2010_2020,dom_migration_rate_1020,int_migration_rate_1020
0,"Callahan County, TX",County or equivalent,13511,14110,565,1407,1796,-389,48,915,963,0.06772259640293095,0.003552660794907853
1,"Jones County, TX",County or equivalent,20237,19875,-317,1692,1939,-247,64,-156,-92,-0.007708652468251223,0.003162524089538964
2,"Taylor County, TX",County or equivalent,131842,139200,7685,21063,13612,7451,3101,-2816,285,-0.021358899288542347,0.02352057766113985
3,"Portage County, OH",County or equivalent,161397,162583,1153,14587,14812,-225,4560,-3127,1433,-0.01937458564905172,0.028253313258610763
4,"Summit County, OH",County or equivalent,541659,538866,-2919,61809,59322,2487,10163,-15250,-5087,-0.028154244644693432,0.018762727103214385
5,"Dougherty County, GA",County or equivalent,94521,86477,-8087,13278,9445,3833,737,-12720,-11983,-0.13457326943218967,0.0077972090858116185
6,"Lee County, GA",County or equivalent,28417,30234,1939,3597,2201,1396,157,369,526,0.012985184924517014,0.0055248618784530384
7,"Terrell County, GA",County or equivalent,9525,8523,-984,1185,1097,88,0,-1081,-1081,-0.11349081364829396,0.0
8,"Worth County, GA",County or equivalent,21692,19972,-1695,2450,2393,57,17,-1785,-1768,-0.0822884012539185,0.0007836990595611285
9,"Linn County, OR",County or equivalent,116887,131054,14373,15074,12929,2145,214,12059,12273,0.10316801697365832,0.0018308280647120726
10,"Albany County, NY",County or equivalent,304085,303654,-545,31521,28058,3463,9285,-13138,-3853,-0.043205024910797966,0.03053422562770278
11,"Rensselaer County, NY",County or equivalent,159342,158108,-1327,16903,15612,1291,2349,-4896,-2547,-0.0307263621644011,0.014741875964905674
12,"Saratoga County, NY",County or equivalent,220123,230298,10700,22195,18828,3367,2597,4867,7464,0.02211036556834134,0.01179794932833007
13,"Schenectady County, NY",County or equivalent,154867,155358,600,18506,15884,2622,3281,-5219,-1938,-0.03369988441695132,0.021185920822383082
14,"Schoharie County, NY",County or equivalent,32684,31132,-1591,2712,2991,-279,99,-1423,-1324,-0.043538122628809205,0.003029005017745686
15,"Bernalillo County, NM",County or equivalent,663940,681666,19197,79605,56600,23005,12267,-15627,-3360,-0.023536765370364792,0.0184760671144983
16,"Sandoval County, NM",County or equivalent,132437,148904,17281,14845,10871,3974,426,12919,13345,0.09754826823319768,0.003216623753180758
17,"Torrance County, NM",County or equivalent,16399,15486,-889,1605,1577,28,400,-1345,-945,-0.0820171961704982,0.02439173120312214
18,"Valencia County, NM",County or equivalent,76805,77574,985,8647,6684,1963,491,-1471,-980,-0.019152398932361172,0.006392812967905735
19,"Grant Parish, LA",County or equivalent,22346,22254,-64,2563,2221,342,107,-498,-391,-0.022285867716817332,0.004788329007428623
20,"Rapides Parish, LA",County or equivalent,131742,128567,-3025,18231,14777,3454,718,-7139,-6421,-0.05418924868303199,0.0054500463026217905
21,"Warren County, NJ",County or equivalent,108572,105624,-3015,9855,10213,-358,1446,-4093,-2647,-0.03769848579744317,0.0133183509560476
22,"Carbon County, PA",County or equivalent,65247,64081,-1163,5937,8317,-2380,172,1099,1271,0.016843686299753247,0.002636136527349917
23,"Lehigh County, PA",County or equivalent,350008,370802,21294,43002,34811,8191,18730,-5441,13289,-0.015545358963223697,0.053513062558570086
24,"Northampton County, PA",County or equivalent,297941,305892,8188,29266,30492,-1226,6204,3502,9706,0.011754004987564652,0.02082291460389809
25,"Blair County, PA",County or equivalent,127049,121007,-6114,13050,16583,-3533,287,-2769,-2482,-0.0217947406118899,0.0022589709482168296
26,"Armstrong County, TX",County or equivalent,1902,1869,-32,200,287,-87,10,45,55,0.02365930599369085,0.005257623554153523
27,"Carson County, TX",County or equivalent,6164,5854,-332,560,677,-117,21,-240,-219,-0.03893575600259572,0.003406878650227125
28,"Oldham County, TX",County or equivalent,2050,2135,83,224,153,71,3,6,9,0.002926829268292683,0.0014634146341463415
29,"Potter County, TX",County or equivalent,121329,116004,-5033,19400,12196,7204,4965,-17285,-12320,-0.1424638792044771,0.0409217911628712
30,"Randall County, TX",County or equivalent,121221,139899,19138,16873,10694,6179,1275,11674,12949,0.09630344577259717,0.010517979557997376
31,"Boone County, IA",County or equivalent,26271,26277,-31,2952,3069,-117,-2,103,101,0.0039206729854211865,-7.612957253245023e-05
32,"Story County, IA",County or equivalent,89661,98237,8695,9301,5291,4010,7400,-2770,4630,-0.030894145726681605,0.08253309688716387
33,"Anchorage Municipality, AK",County or equivalent,293760,287095,-5157,45399,17327,28072,9573,-43029,-33456,-0.14647671568627452,0.032587826797385616
34,"Matanuska-Susitna Borough, AK",County or equivalent,89731,110213,21232,14306,6012,8294,888,11907,12795,0.13269661543948022,0.009896245444718102
35,"Washtenaw County, MI",County or equivalent,345980,366473,21056,37579,23063,14516,19183,-12452,6731,-0.03599051968321868,0.05544540146829297
36,"Calhoun County, AL",County or equivalent,118420,113469,-5064,13556,14808,-1252,540,-4306,-3766,-0.0363621009964533,0.004560040533693633
37,"Calumet County, WI",County or equivalent,49041,50209,1228,5371,3436,1935,141,-845,-704,-0.01723048061825819,0.002875145286596929
38,"Outagamie County, WI",County or equivalent,176843,188766,12152,23269,14164,9105,1817,1370,3187,0.007746984613470706,0.010274650396114068
39,"Buncombe County, NC",County or equivalent,238743,263477,25162,26080,26300,-220,1763,23376,25139,0.09791281838629824,0.007384509702902284
40,"Haywood County, NC",County or equivalent,58930,62972,3942,5799,7851,-2052,29,5973,6002,0.10135754284744612,0.0004921092821992193
41,"Henderson County, NC",County or equivalent,106894,118445,11729,10959,14100,-3141,121,14655,14776,0.13709843396261714,0.0011319625049114074
42,"Madison County, NC",County or equivalent,20798,21740,937,1994,2509,-515,104,1347,1451,0.06476584286950668,0.005000480815463025
43,"Clarke County, GA",County or equivalent,117389,127795,11125,13992,7535,6457,3671,849,4520,0.007232364190852636,0.03127209534113077
44,"Madison County, GA",County or equivalent,28221,30457,2283,3470,2997,473,138,1688,1826,0.059813613975408374,0.004889975550122249
45,"Oconee County, GA",County or equivalent,32935,41124,8284,3491,2472,1019,352,6920,7272,0.2101108243509944,0.010687718232882951
46,"Oglethorpe County, GA",County or equivalent,14891,15383,509,1608,1489,119,39,351,390,0.02357128466859177,0.0026190316298435297
47,"Barrow County, GA",County or equivalent,69670,85588,16239,10754,6010,4744,885,10532,11417,0.15116980048801493,0.01270274149562222
48,"Bartow County, GA",County or equivalent,100041,109426,9343,13234,9186,4048,341,4994,5335,0.049919532991473496,0.0034086024729860762
49,"Butts County, GA",County or equivalent,23776,25426,1741,2771,2644,127,1,1605,1606,0.06750504710632571,4.2059219380888284e-05
50,"Carroll County, GA",County or equivalent,110655,121633,11068,15307,10587,4720,1057,5309,6366,0.04797794948262618,0.009552211829560344
51,"Cherokee County, GA",County or equivalent,215226,265274,50874,28646,14992,13654,2369,34682,37051,0.16114224117903972,0.011007034466096105
52,"Clayton County, GA",County or equivalent,259899,292646,33007,43599,17114,26485,5829,557,6386,0.0021431402198546358,0.022427943162536216
53,"Cobb County, GA",County or equivalent,689542,762944,74868,94924,43006,51918,22655,581,23236,0.0008425882687348994,0.03285514152872487
54,"Coweta County, GA",County or equivalent,127939,150849,23481,16830,10234,6596,1508,15311,16819,0.1196742197453474,0.01178686717888994
55,"Dawson County, GA",County or equivalent,22325,27113,4736,2540,2112,428,68,4236,4304,0.1897424412094065,0.003045912653975364
56,"DeKalb County, GA",County or equivalent,692536,762009,69978,111976,46741,65235,45038,-40070,4968,-0.05785980800998071,0.06503344230480437
57,"Douglas County, GA",County or equivalent,132575,147988,15707,17669,9654,8015,1214,6480,7694,0.048877993588534785,0.009157080897605129
58,"Fayette County, GA",County or equivalent,106938,115821,9265,8671,8629,42,1952,7306,9258,0.06831996109895454,0.018253567487703157
59,"Forsyth County, GA",County or equivalent,176736,250847,75349,23878,11285,12593,5000,57196,62196,0.3236239362665218,0.02829078399420605
60,"Fulton County, GA",County or equivalent,925622,1077402,157009,127279,64807,62472,37221,56447,93668,0.060982776986718126,0.040211879147211284
61,"Gwinnett County, GA",County or equivalent,807979,942627,137386,118457,42232,76225,31886,29582,61468,0.03661233769689559,0.039463896957717966
62,"Haralson County, GA",County or equivalent,28763,30383,1603,3574,3630,-56,2,1665,1667,0.057886868546396415,6.95337760317074e-05
63,"Heard County, GA",County or equivalent,11838,11973,145,1318,1310,8,-14,153,139,0.012924480486568676,-0.0011826322013853694
64,"Henry County, GA",County or equivalent,205042,239139,35362,25018,14710,10308,1530,23584,25114,0.11502033729674895,0.007461885857531628
65,"Jasper County, GA",County or equivalent,13888,14483,589,1686,1410,276,21,287,308,0.02066532258064516,0.0015120967741935483
66,"Lamar County, GA",County or equivalent,18260,19261,954,2082,2139,-57,217,772,989,0.042278203723986864,0.011883899233296823
67,"Meriwether County, GA",County or equivalent,21817,21164,-812,2557,2769,-212,5,-605,-600,-0.027730668744557,0.0002291790805335289
68,"Morgan County, GA",County or equivalent,17897,19636,1769,2014,1851,163,1,1609,1610,0.08990333575459575,5.58752863608426e-05
69,"Newton County, GA",County or equivalent,100128,113295,13331,13808,8779,5029,604,7748,8352,0.07738095238095237,0.006032278683285396
70,"Paulding County, GA",County or equivalent,142826,173359,30974,19464,9277,10187,771,20028,20799,0.1402265693921275,0.005398176802542954
71,"Pickens County, GA",County or equivalent,29434,33127,3725,3109,3346,-237,51,3895,3946,0.1323299585513352,0.0017326900862947609
72,"Pike County, GA",County or equivalent,17929,19121,1242,1781,1790,-9,18,1248,1266,0.06960789781917562,0.0010039600646996486
73,"Rockdale County, GA",County or equivalent,85359,90939,5766,10091,6985,3106,437,2234,2671,0.02617181550861655,0.005119553884183272
74,"Spalding County, GA",County or equivalent,64096,67414,3307,8614,7694,920,90,2308,2398,0.036008487269096355,0.0014041437843235148
75,"Walton County, GA",County or equivalent,83997,96875,13067,10955,8323,2632,284,10170,10454,0.12107575270545375,0.0033810731335642942
76,"Atlantic County, NJ",County or equivalent,274654,262945,-11587,31062,27578,3484,7493,-22691,-15198,-0.0826166740699207,0.02728159793776897
77,"Lee County, AL",County or equivalent,140815,166831,26531,18526,10814,7712,5129,13498,18627,0.09585626531264424,0.03642367645492313
78,"Burke County, GA",County or equivalent,23343,22648,-686,3223,2503,720,-10,-1420,-1430,-0.060831941052992326,-0.0004283939510774108
79,"Columbia County, GA",County or equivalent,124951,160377,36364,17823,9280,8543,2130,25479,27609,0.20391193347792336,0.01704668229946139
80,"Lincoln County, GA",County or equivalent,7970,8031,35,764,918,-154,38,150,188,0.018820577164366373,0.004767879548306148
81,"McDuffie County, GA",County or equivalent,21803,21162,-703,2964,2521,443,-110,-1030,-1140,-0.047241205338714856,-0.00504517726918314
82,"Richmond County, GA",County or equivalent,201122,202079,1488,29913,20254,9659,3237,-11333,-8096,-0.05634888276767335,0.016094708684281183
83,"Aiken County, SC",County or equivalent,160558,172895,12767,19388,17900,1488,1670,9686,11356,0.06032710920664184,0.010401225725283077
84,"Edgefield County, SC",County or equivalent,26965,27120,154,2002,2285,-283,69,383,452,0.014203597255701838,0.002558872612646023
85,"Bastrop County, TX",County or equivalent,74381,91601,17371,10270,6876,3394,-54,13962,13908,0.1877092268186768,-0.0007259918527580968
86,"Caldwell County, TX",County or equivalent,38087,43979,5965,5333,3397,1936,236,3801,4037,0.09979783128101452,0.006196339958516029
87,"Hays County, TX",County or equivalent,158086,241365,84387,24260,10314,13946,3028,66528,69556,0.4208342294700353,0.0191541312956239
88,"Travis County, TX",County or equivalent,1030392,1300503,276189,160931,55798,105133,53658,114993,168651,0.11160121584794913,0.052075326671790934
89,"Williamson County, TX",County or equivalent,426568,617855,195084,65713,26158,39555,10897,143286,154183,0.33590424035558225,0.025545751204966147
90,"Kern County, CA",County or equivalent,841365,901362,61743,140814,60952,79862,5264,-23200,-17936,-0.027574239479892796,0.006256499854403261
91,"Anne Arundel County, MD",County or equivalent,539305,582777,45142,70690,43554,27136,8798,9536,18334,0.017682016669602545,0.01631358878556661
92,"Baltimore County, MD",County or equivalent,806654,826017,20706,100239,83462,16777,26420,-21878,4542,-0.027121913484591902,0.0327525804124197
93,"Carroll County, MD",County or equivalent,167230,169092,1937,16827,15737,1090,673,252,925,0.0015069066555043953,0.004024397536327214
94,"Harford County, MD",County or equivalent,245236,256805,11981,27495,21280,6215,2649,3281,5930,0.013378949257042196,0.01080183986037939
95,"Howard County, MD",County or equivalent,288618,328200,41090,35516,16850,18666,12286,10293,22579,0.0356630563582313,0.042568377578668
96,"Queen Anne's County, MD",County or equivalent,47809,51167,3378,4872,4265,607,448,2367,2815,0.049509506578259324,0.009370620594448743
97,"Baltimore city, MD",County or equivalent,620942,586131,-34646,86519,66596,19923,18179,-72307,-54128,-0.1164472688270402,0.029276486370707733
98,"Penobscot County, ME",County or equivalent,153864,151655,-2277,14727,16299,-1572,1236,-1851,-615,-0.012030104507877086,0.008033068164092966
99,"Barnstable County, MA",County or equivalent,215909,213164,-2719,15862,29924,-14062,3821,7747,11568,0.035880857212992515,0.0176972706093771
100,"Ascension Parish, LA",County or equivalent,107894,128665,21446,17153,7772,9381,867,11096,11963,0.10284167794316644,0.008035664633807255
101,"Assumption Parish, LA",County or equivalent,23332,21621,-1796,2605,2291,314,129,-2242,-2113,-0.0960912052117264,0.005528887364992285
102,"East Baton Rouge Parish, LA",County or equivalent,440937,439729,-802,61359,38941,22418,8704,-31790,-23086,-0.07209646729578148,0.019739781420021453
103,"East Feliciana Parish, LA",County or equivalent,20150,18882,-1372,2090,2474,-384,11,-994,-983,-0.04933002481389578,0.0005459057071960298
104,"Iberville Parish, LA",County or equivalent,33389,32070,-1334,4060,3359,701,49,-2071,-2022,-0.06202641588547126,0.0014675491928479438
105,"Livingston Parish, LA",County or equivalent,128351,143737,16049,18735,10926,7809,449,7748,8197,0.06036571588846211,0.003498219725596217
106,"Pointe Coupee Parish, LA",County or equivalent,22814,21529,-1271,2806,2613,193,47,-1506,-1459,-0.06601209783466293,0.002060138511440344
107,"St. Helena Parish, LA",County or equivalent,11206,10081,-1132,1181,1216,-35,10,-1116,-1106,-0.09958950562198822,0.0008923790826343029
108,"West Baton Rouge Parish, LA",County or equivalent,23964,26792,2994,3670,2100,1570,44,1355,1399,0.056543148055416464,0.0018360874645301285
109,"West Feliciana Parish, LA",County or equivalent,15636,15465,-155,1258,1292,-34,102,-220,-118,-0.014070094653364031,0.006523407521105142
110,"Calhoun County, MI",County or equivalent,135953,133580,-2570,16516,15414,1102,2428,-6085,-3657,-0.04475811493677962,0.017859113075842387
111,"Bay County, MI",County or equivalent,107678,102387,-5386,10569,12501,-1932,254,-3656,-3402,-0.033953082338082065,0.002358884823269377
112,"Hardin County, TX",County or equivalent,54785,58305,3670,7057,5827,1230,165,2323,2488,0.04240211736789267,0.003011773295610112
113,"Jefferson County, TX",County or equivalent,252457,250127,-2150,35953,25488,10465,5325,-18017,-12692,-0.07136660896707163,0.021092700935208767
114,"Orange County, TX",County or equivalent,82015,82878,1039,11236,9782,1454,115,-469,-354,-0.005718466134243736,0.0014021825275864171
115,"Fayette County, WV",County or equivalent,46029,42062,-3983,5029,6718,-1689,164,-2435,-2271,-0.05290143170609833,0.0035629711703491283
116,"Raleigh County, WV",County or equivalent,78921,72920,-5945,8881,10615,-1734,434,-4626,-4192,-0.058615577602919376,0.005499170056132081
117,"Whatcom County, WA",County or equivalent,201549,231016,29870,22952,16707,6245,3982,19658,23640,0.09753459456509336,0.019756982173069572
118,"Deschutes County, OR",County or equivalent,157744,201769,44041,18125,14644,3481,-95,40320,40225,0.2556040166345471,-0.0006022416066538189
119,"Carbon County, MT",County or equivalent,10063,10921,843,806,1018,-212,51,1003,1054,0.09967206598429892,0.005068071151744014
120,"Stillwater County, MT",County or equivalent,9112,9888,795,867,890,-23,91,728,819,0.07989464442493416,0.00998683055311677
121,"Yellowstone County, MT",County or equivalent,148405,162990,14996,19855,15106,4749,931,9322,10253,0.06281459519557966,0.0062733735386274045
122,"Broome County, NY",County or equivalent,200474,189420,-11250,20449,21690,-1241,4173,-14232,-10059,-0.07099174955355808,0.02081566686951924
123,"Tioga County, NY",County or equivalent,51012,47904,-3148,4826,4654,172,-13,-3330,-3343,-0.0652787579393084,-0.00025484199796126404
124,"Bibb County, AL",County or equivalent,22858,22136,-768,2613,2643,-30,118,-854,-736,-0.03736109895878904,0.005162306413509493
125,"Blount County, AL",County or equivalent,57372,57879,557,6987,6540,447,138,15,153,0.00026145157916753815,0.0024053545283413517
126,"Chilton County, AL",County or equivalent,43645,44397,772,5618,5156,462,183,156,339,0.0035742925879253063,0.004192920151220071
127,"Jefferson County, AL",County or equivalent,658230,655342,-3222,89005,73118,15887,6148,-24798,-18650,-0.03767376145116449,0.009340200233960774
128,"St. Clair County, AL",County or equivalent,83587,90739,7373,10495,9401,1094,445,5865,6310,0.07016641343749626,0.005323794369937909
129,"Shelby County, AL",County or equivalent,196036,221428,26171,24124,14809,9315,2277,14627,16904,0.07461384643636883,0.01161521353220837
130,"Burleigh County, ND",County or equivalent,81708,96212,14904,12719,7271,5448,914,8351,9265,0.10220541440250648,0.01118617516032702
131,"Morton County, ND",County or equivalent,27570,31503,4034,4562,2938,1624,367,1985,2352,0.07199854914762423,0.013311570547696772
132,"Oliver County, ND",County or equivalent,1841,1926,78,225,121,104,-1,-26,-27,-0.014122759369907659,-0.0005431830526887562
133,"Giles County, VA",County or equivalent,17317,16663,-625,1752,2327,-575,26,-66,-40,-0.003811283709649477,0.0015014147947104
134,"Montgomery County, VA",County or equivalent,94560,98391,3972,8735,6439,2296,5346,-3661,1685,-0.03871615905245347,0.056535532994923865
135,"Pulaski County, VA",County or equivalent,34830,33935,-922,3287,4603,-1316,45,378,423,0.010852713178294572,0.0012919896640826874
136,"Radford city, VA",County or equivalent,16432,18255,1860,1218,1135,83,319,1424,1743,0.0866601752677702,0.019413339824732232
137,"McLean County, IL",County or equivalent,169815,171256,1678,20671,12100,8571,6160,-13143,-6983,-0.07739598975355534,0.036274769602214166
138,"Monroe County, IN",County or equivalent,138574,148219,10262,13178,9555,3623,9519,-2849,6670,-0.020559412299565576,0.06869253972606694
139,"Owen County, IN",County or equivalent,21566,20833,-740,2306,2430,-124,32,-649,-617,-0.03009366595567096,0.001483817119540017
140,"Columbia County, PA",County or equivalent,67355,64842,-2454,5945,7201,-1256,257,-1409,-1152,-0.020919011209264347,0.003815603889837429
141,"Montour County, PA",County or equivalent,18298,18042,-214,2196,2309,-113,336,-421,-85,-0.023007979014099903,0.018362662586074985
142,"Ada County, ID",County or equivalent,393369,494399,102035,51321,29449,21872,6667,73198,79865,0.1860797368374224,0.016948463147833204
143,"Boise County, ID",County or equivalent,7005,8065,1038,447,559,-112,81,1056,1137,0.15074946466809422,0.011563169164882228
144,"Canyon County, ID",County or equivalent,189365,237053,48123,31604,14882,16722,265,31060,31325,0.1640218625405962,0.0013994138304332902
145,"Gem County, ID",County or equivalent,16686,18703,1984,2016,2087,-71,130,1927,2057,0.1154860361980103,0.007790962483519119
146,"Owyhee County, ID",County or equivalent,11474,12133,607,1437,985,452,35,120,155,0.010458427749694962,0.003050374760327697
147,"Norfolk County, MA",County or equivalent,673059,709409,38458,73746,59432,14314,33181,-8567,24614,-0.012728453226240196,0.04929879847086214
148,"Plymouth County, MA",County or equivalent,495937,523738,28805,52496,46601,5895,15072,8275,23347,0.016685587080617098,0.030390956915898593
149,"Suffolk County, MA",County or equivalent,725786,801582,79410,95611,49524,46087,95136,-61469,33667,-0.08469300868300023,0.13107996020865656
150,"Essex County, MA",County or equivalent,745469,791263,48181,86525,68356,18169,44497,-13921,30576,-0.018674150098796864,0.059689940158477416
151,"Middlesex County, MA",County or equivalent,1507694,1609379,106272,176352,117275,59077,115276,-66984,48292,-0.04442811339701557,0.07645848560782227
152,"Rockingham County, NH",County or equivalent,295300,311307,16100,26952,24543,2409,3196,10748,13944,0.03639688452421266,0.01082289197426346
153,"Strafford County, NH",County or equivalent,123203,131533,8387,12430,10862,1568,3520,3305,6825,0.026825645479412026,0.02857073285553112
154,"Boulder County, CO",County or equivalent,295056,327171,32611,28618,18203,10415,8800,13329,22129,0.04517447535383114,0.029824846808741395
155,"Allen County, KY",County or equivalent,20023,21303,1360,2544,2338,206,15,1152,1167,0.05753383608849823,0.000749138490735654
156,"Butler County, KY",County or equivalent,12742,12703,-3,1581,1570,11,81,-87,-6,-0.006827813530058076,0.006356929838329932
157,"Edmonson County, KY",County or equivalent,12239,12235,48,1136,1441,-305,21,337,358,0.0275349293242912,0.0017158264564098376
158,"Warren County, KY",County or equivalent,114348,134510,20728,16593,10073,6520,5205,8964,14169,0.07839227620946584,0.0455189421765138
159,"Kitsap County, WA",County or equivalent,251696,272787,21644,30811,22396,8415,2663,10476,13139,0.04162163880236476,0.0105802237619986
160,"Fairfield County, CT",County or equivalent,919371,942426,25516,102311,68987,33324,49354,-57114,-7760,-0.062122907944670874,0.0536823545663285
161,"Cameron County, TX",County or equivalent,407608,424180,17966,71420,26882,44538,3277,-30003,-26726,-0.07360748562344213,0.008039587054228572
162,"Brantley County, GA",County or equivalent,18462,19202,793,2202,1982,220,-13,584,571,0.03163254251977034,-0.0007041490629400933
163,"Glynn County, GA",County or equivalent,79750,85568,5938,9862,8819,1043,854,4060,4914,0.05090909090909091,0.01070846394984326
164,"McIntosh County, GA",County or equivalent,14312,14387,55,1193,1301,-108,15,135,150,0.009432643935159309,0.0010480715483510339
165,"Erie County, NY",County or equivalent,919160,917241,-1888,101743,100550,1193,24322,-26866,-2544,-0.029228861134078937,0.02646111667174376
166,"Niagara County, NY",County or equivalent,216474,208396,-8083,21941,24510,-2569,1467,-6872,-5405,-0.03174515184271552,0.006776795365725214
167,"Alamance County, NC",County or equivalent,151437,171346,20186,18788,16815,1973,751,17497,18248,0.11553979542648098,0.004959157933662183
168,"Chittenden County, VT",County or equivalent,156774,164306,7771,15547,11246,4301,6109,-2517,3592,-0.016054958092540855,0.03896692053529284
169,"Franklin County, VT",County or equivalent,47821,49685,1926,5854,4223,1631,363,-29,334,-0.0006064281382656155,0.007590807385876498
170,"Grand Isle County, VT",County or equivalent,6948,7169,199,613,608,5,9,191,200,0.02748992515831894,0.0012953367875647669
171,"St. Mary's County, MD",County or equivalent,105772,114687,9541,14370,8156,6214,1563,1790,3353,0.016923193283666756,0.014777067654955943
172,"Carroll County, OH",County or equivalent,28859,26897,-1950,2836,3266,-430,8,-1529,-1521,-0.05298173879898818,0.00027720988253231225
173,"Stark County, OH",County or equivalent,375348,369772,-5789,42308,43181,-873,1415,-6000,-4585,-0.015985165766168995,0.003769834926521522
174,"Lee County, FL",County or equivalent,620481,790767,172006,67541,70855,-3314,29568,144482,174050,0.2328548335887803,0.04765335280210031
175,"Alexander County, IL",County or equivalent,8205,5497,-2741,852,984,-132,2,-2647,-2645,-0.3226081657525899,0.0002437538086532602
176,"Bollinger County, MO",County or equivalent,12349,12111,-254,1380,1397,-17,4,-238,-234,-0.01927281561260021,0.00032391286743865903
177,"Cape Girardeau County, MO",County or equivalent,75905,79512,3836,9295,7938,1357,1418,1109,2527,0.014610368223437191,0.01868124629471049
178,"Jackson County, IL",County or equivalent,60371,56675,-3529,6818,4890,1928,2185,-7778,-5593,-0.1288366931142436,0.036192874062049664
179,"Johnson County, IL",County or equivalent,12598,12358,-213,1108,1321,-213,2,-3,-1,-0.00023813303698999838,0.00015875535799333228
180,"Williamson County, IL",County or equivalent,66440,66415,42,7869,7851,18,465,-402,63,-0.00605057194461168,0.006998795906080674
181,"Carson City, NV",County or equivalent,54983,56034,765,6019,7322,-1303,-148,2192,2044,0.039866867940999945,-0.0026917410836076604
182,"Natrona County, WY",County or equivalent,75477,80815,5367,10903,7370,3533,436,1267,1703,0.016786570743405275,0.005776594194257853
183,"Benton County, IA",County or equivalent,26049,25414,-657,2961,2442,519,63,-1245,-1182,-0.04779454105723828,0.0024185189450650697
184,"Jones County, IA",County or equivalent,20687,20617,-17,2114,2079,35,146,-191,-45,-0.009232851549282158,0.0070575723884565185
185,"Linn County, IA",County or equivalent,211713,227854,16612,28253,17783,10470,3861,2474,6335,0.01168563101935167,0.018236952855989003
186,"Franklin County, PA",County or equivalent,149925,155637,6012,18702,15687,3015,2195,966,3161,0.0064432216108054035,0.014640653660163415
187,"Champaign County, IL",County or equivalent,201558,209192,8105,24032,13406,10626,18263,-20912,-2649,-0.10375177368300936,0.0906091546850038
188,"Piatt County, IL",County or equivalent,16710,16355,-372,1800,1765,35,9,-414,-405,-0.024775583482944345,0.0005385996409335727
189,"Boone County, WV",County or equivalent,24607,21055,-3569,2494,3297,-803,-14,-2766,-2780,-0.11240703864753933,-0.0005689437964806763
190,"Clay County, WV",County or equivalent,9382,8341,-1053,1037,1164,-127,-5,-930,-935,-0.09912598593050524,-0.0005329354082285226
191,"Jackson County, WV",County or equivalent,29233,28453,-762,3254,3671,-417,130,-451,-321,-0.015427769985974752,0.004447029042520439
192,"Kanawha County, WV",County or equivalent,192925,176253,-16803,20858,25687,-4829,1158,-13006,-11848,-0.06741479849682519,0.0060023325126344436
193,"Lincoln County, WV",County or equivalent,21674,20043,-1668,2544,2891,-347,16,-1324,-1308,-0.06108701670203931,0.0007382116821998707
194,"Berkeley County, SC",County or equivalent,179492,235987,57612,27552,14456,13096,4308,39879,44187,0.22217703295968624,0.024001069685557017
195,"Charleston County, SC",County or equivalent,350998,417981,67819,49739,32499,17240,4855,44906,49761,0.12793805092906513,0.013831987646653256
196,"Dorchester County, SC",County or equivalent,137005,165737,29627,18754,11073,7681,2084,19689,21773,0.14371008357359222,0.015211123681617459
197,"Anson County, NC",County or equivalent,26853,24097,-2832,2625,3173,-548,225,-2537,-2312,-0.09447733958961754,0.008378952072394147
198,"Cabarrus County, NC",County or equivalent,178564,221479,43363,24847,15830,9017,1626,32566,34192,0.18237718689097465,0.009105978808718442
199,"Gaston County, NC",County or equivalent,206114,226568,20468,26037,23577,2460,1188,16882,18070,0.08190612961759026,0.0057638006151935345
200,"Iredell County, NC",County or equivalent,159788,185770,26305,18835,15745,3090,1990,21243,23233,0.13294490199514356,0.012454001552056473
201,"Lincoln County, NC",County or equivalent,78127,88097,10096,8272,8022,250,312,9564,9876,0.1224160661487066,0.0039934977664571785
202,"Mecklenburg County, NC",County or equivalent,923292,1128945,209270,147136,60901,86235,49159,72810,121969,0.07885912582368307,0.053243177672935536
203,"Rowan County, NC",County or equivalent,138329,142495,4002,16093,16458,-365,429,4026,4455,0.029104526165879895,0.0031013019684953988
204,"Union County, NC",County or equivalent,202110,244562,43234,24352,14176,10176,1025,31939,32964,0.15802780663994853,0.005071495720152392
205,"Chester County, SC",County or equivalent,33163,32232,-927,3929,4226,-297,-16,-604,-620,-0.018213068781473333,-0.0004824653981847238
206,"Lancaster County, SC",County or equivalent,76976,100926,24273,10001,8946,1055,534,22481,23015,0.29205206817709417,0.0069372271876948655
207,"York County, SC",County or equivalent,226871,289105,63072,30073,20945,9128,2004,51621,53625,0.22753459014153415,0.008833213588338747
208,"Albemarle County, VA",County or equivalent,99196,110652,11668,11530,8447,3083,3433,5201,8634,0.05243154965926045,0.034608250332674714
209,"Fluvanna County, VA",County or equivalent,25792,27422,1679,2704,2237,467,119,1108,1227,0.0429590570719603,0.004613833746898263
210,"Greene County, VA",County or equivalent,18480,20131,1719,2251,1594,657,292,782,1074,0.042316017316017314,0.0158008658008658
211,"Nelson County, VA",County or equivalent,14978,14755,-260,1369,1908,-539,60,230,290,0.015355855254373081,0.0040058752837495
212,"Charlottesville city, VA",County or equivalent,43467,46950,3525,5312,2906,2406,3469,-2344,1125,-0.05392596682540778,0.07980767018657832
213,"Catoosa County, GA",County or equivalent,64073,67996,4068,7275,6305,970,152,2993,3145,0.04671234373292963,0.002372294102039861
214,"Dade County, GA",County or equivalent,16632,16057,-587,1633,1844,-211,-32,-341,-373,-0.0205026455026455,-0.0019240019240019239
215,"Walker County, GA",County or equivalent,68876,70116,1377,7576,7922,-346,208,1559,1767,0.022634880074336488,0.003019919855973053
216,"Hamilton County, TN",County or equivalent,337235,371662,35185,43166,36214,6952,3936,24199,28135,0.07175708333951103,0.011671386421931294
217,"Marion County, TN",County or equivalent,28227,28924,698,3197,3781,-584,36,1260,1296,0.044638112445530884,0.001275374641300882
218,"Sequatchie County, TN",County or equivalent,14124,15176,1059,1631,1631,0,-19,1081,1062,0.0765363919569527,-0.0013452279807419994
219,"Laramie County, WY",County or equivalent,92246,100595,8710,12975,8353,4622,731,3325,4056,0.03604492335711034,0.00792446284933764
220,"Cook County, IL",County or equivalent,5198977,5108284,-86740,686879,418298,268581,146806,-501722,-354916,-0.09650398530326254,0.028237478257741862
221,"DuPage County, IL",County or equivalent,917996,917481,740,108206,63877,44329,25494,-69376,-43882,-0.07557331404494137,0.027771362838182302
222,"Grundy County, IL",County or equivalent,50155,50993,914,6193,4103,2090,70,-1240,-1170,-0.024723357591466454,0.001395673412421493
223,"McHenry County, IL",County or equivalent,309121,305888,-2998,32574,21334,11240,970,-15306,-14336,-0.04951459137360451,0.003137929807421689
224,"Will County, IL",County or equivalent,678829,688726,11136,79232,44899,34333,4157,-27421,-23264,-0.040394561811590256,0.006123780804886061
225,"DeKalb County, IL",County or equivalent,105151,104491,-671,11950,7363,4587,2381,-7721,-5340,-0.07342773725404418,0.022643626784338712
226,"Kane County, IL",County or equivalent,516060,531010,15692,68272,32624,35648,2223,-22091,-19868,-0.04280703794132465,0.004307638646668993
227,"Kendall County, IL",County or equivalent,115369,130638,15838,16579,5765,10814,1115,4004,5119,0.034706030216089236,0.009664641281453423
228,"Jasper County, IN",County or equivalent,33497,33440,-41,3882,3373,509,52,-589,-537,-0.017583664208735108,0.00155237782487984
229,"Lake County, IN",County or equivalent,495972,487536,-8576,60605,49845,10760,1375,-20723,-19348,-0.04178260063068077,0.002772333922076246
230,"Newton County, IN",County or equivalent,14234,13907,-332,1490,1641,-151,181,-354,-173,-0.02487002950681467,0.012716032035970213
231,"Porter County, IN",County or equivalent,164492,170980,6692,17738,15187,2551,818,3461,4279,0.021040536925807943,0.004972886219390607
232,"Lake County, IL",County or equivalent,704179,693593,-9803,78712,46294,32418,14257,-56959,-42702,-0.08088710398918457,0.02024627260966317
233,"Kenosha County, WI",County or equivalent,166629,169671,3247,19680,14491,5189,701,-2563,-1862,-0.015381476213624281,0.004206950770874218
234,"Butte County, CA",County or equivalent,219951,212744,-7261,24618,23905,713,1573,-9408,-7835,-0.042773163113602575,0.007151592854772198
235,"Dearborn County, IN",County or equivalent,50082,49824,-201,5328,4842,486,4,-676,-672,-0.01349786350385368,7.986901481570224e-05
236,"Franklin County, IN",County or equivalent,23058,22761,-336,2604,2188,416,88,-840,-752,-0.03642987249544627,0.003816462832856275
237,"Ohio County, IN",County or equivalent,6085,5892,-205,570,662,-92,31,-141,-110,-0.023171733771569437,0.005094494658997535
238,"Union County, IN",County or equivalent,7537,7119,-397,738,734,4,20,-424,-404,-0.056255804696828976,0.00265357569324665
239,"Boone County, KY",County or equivalent,119380,135396,16586,17337,8681,8656,2074,5933,8007,0.04969844195007539,0.017373094320656726
240,"Bracken County, KY",County or equivalent,8513,8286,-199,1046,964,82,24,-305,-281,-0.035827557852695875,0.0028192176670973805
241,"Campbell County, KY",County or equivalent,90806,94020,3680,11432,8775,2657,1092,-59,1033,-0.0006497368015329384,0.012025637072440145
242,"Gallatin County, KY",County or equivalent,8607,8779,198,1145,998,147,73,-21,52,-0.0024398745207389336,0.008481468572092483
243,"Grant County, KY",County or equivalent,24681,25387,727,3730,2403,1327,-52,-550,-602,-0.022284348284105183,-0.0021068838377699445
244,"Kenton County, KY",County or equivalent,159967,167949,8221,23471,15116,8355,1321,-1330,-9,-0.008314214806803905,0.008257953202848087
245,"Pendleton County, KY",County or equivalent,14915,14586,-288,1773,1602,171,39,-497,-458,-0.0333221589004358,0.002614817298022125
246,"Brown County, OH",County or equivalent,44868,43414,-1417,5101,5202,-101,-17,-1294,-1311,-0.028840153338682364,-0.000378889186056878
247,"Butler County, OH",County or equivalent,369111,385648,17510,46236,33608,12628,7021,-1942,5079,-0.005261289964265492,0.019021378392949543
248,"Clermont County, OH",County or equivalent,197613,207449,10079,23868,17820,6048,1309,2888,4197,0.014614423140178025,0.006624058133827228
249,"Hamilton County, OH",County or equivalent,802295,817985,15614,111144,81189,29955,19839,-33806,-13967,-0.04213662056974056,0.024727812089069483
250,"Warren County, OH",County or equivalent,213445,238412,25617,24565,17249,7316,4802,13699,18501,0.06418046803626228,0.02249759891306894
251,"Christian County, KY",County or equivalent,74145,71478,-2465,15231,6231,9000,2451,-13982,-11531,-0.18857643806055704,0.03305684806797492
252,"Trigg County, KY",County or equivalent,14321,14776,449,1564,1772,-208,16,645,661,0.04503875427693597,0.0011172404161720552
253,"Montgomery County, TN",County or equivalent,173181,214251,41890,34732,12755,21977,4551,14951,19502,0.08633164146182318,0.02627886430959516
254,"Stewart County, TN",County or equivalent,13347,13859,548,1394,1669,-275,25,802,827,0.060088409380385115,0.0018730800929047727
255,"Bradley County, TN",County or equivalent,99086,109071,10145,12292,10658,1634,1248,7275,8523,0.07342106856669964,0.012595119391235894
256,"Polk County, TN",County or equivalent,16813,16835,14,1648,2350,-702,-2,720,718,0.04282400523404509,-0.00011895557009456967
257,"Cuyahoga County, OH",County or equivalent,1278103,1227883,-52236,149786,141721,8065,31194,-91328,-60134,-0.07145589987661399,0.024406483671503783
258,"Geauga County, OH",County or equivalent,93381,93271,-126,9430,8478,952,397,-1443,-1046,-0.015452822308606675,0.004251400177766354
259,"Lake County, OH",County or equivalent,230010,229569,-482,23012,25278,-2266,2445,-472,1973,-0.0020520846919699146,0.010629972609886526
260,"Lorain County, OH",County or equivalent,301479,312172,10798,34052,31388,2664,4769,3614,8383,0.01198756795664043,0.015818680571449417
261,"Medina County, OH",County or equivalent,172503,180912,8583,17878,15048,2830,1059,4853,5912,0.028132844066480003,0.006139023669153579
262,"Kootenai County, ID",County or equivalent,138860,170628,32162,18081,14096,3985,-359,28493,28134,0.2051922799942388,-0.0025853377502520524
263,"Brazos County, TX",County or equivalent,195671,232555,37694,27484,10332,17152,13116,7323,20439,0.03742506554369325,0.06703088347276806
264,"Burleson County, TX",County or equivalent,17238,18514,1327,2053,2198,-145,312,1164,1476,0.06752523494604942,0.01809954751131222
265,"Robertson County, TX",County or equivalent,16551,17155,538,2139,1958,181,168,194,362,0.011721346142227057,0.010150444081928585
266,"El Paso County, CO",County or equivalent,627088,728310,106054,94876,44122,50754,12030,43130,55160,0.06877822570356952,0.019183910392161864
267,"Teller County, CO",County or equivalent,23474,25529,2169,1858,1676,182,-29,2014,1985,0.08579705205759564,-0.0012354093891113573
268,"Boone County, MO",County or equivalent,163208,182991,20339,21470,11040,10430,6565,3334,9899,0.0204279201999902,0.04022474388510367
269,"Cooper County, MO",County or equivalent,17601,17102,-500,2023,1958,65,58,-608,-550,-0.034543491847054145,0.003295267314357139
270,"Howard County, MO",County or equivalent,10141,10001,-141,1196,1048,148,45,-337,-292,-0.03323143674193866,0.004437432205896854
271,"Calhoun County, SC",County or equivalent,15098,14554,-625,1415,1797,-382,22,-269,-247,-0.017816929394621803,0.0014571466419393295
272,"Fairfield County, SC",County or equivalent,23860,22059,-1918,2205,3039,-834,152,-1229,-1077,-0.05150880134115675,0.006370494551550711
273,"Kershaw County, SC",County or equivalent,61700,67472,5886,7538,6880,658,334,4928,5262,0.07987034035656403,0.005413290113452188
274,"Lexington County, SC",County or equivalent,263365,303946,41492,33172,24823,8349,4150,28952,33102,0.10993108423670572,0.01575759876976819
275,"Richland County, SC",County or equivalent,385754,419051,34626,49165,30690,18475,10770,5566,16336,0.014428884729646357,0.02791934756347309
276,"Saluda County, SC",County or equivalent,19905,20315,458,2470,2164,306,233,-65,168,-0.003265511178095956,0.011705601607636272
277,"Russell County, AL",County or equivalent,53327,58237,5271,8594,6103,2491,236,2350,2586,0.04406773304329889,0.004425525531156825
278,"Chattahoochee County, GA",County or equivalent,11185,10551,-712,2319,350,1969,1565,-4311,-2746,-0.3854269110415736,0.1399195350916406
279,"Harris County, GA",County or equivalent,32147,36080,4088,3054,2791,263,59,3792,3851,0.11795812984104273,0.00183531900332846
280,"Marion County, GA",County or equivalent,8741,8516,-222,918,850,68,91,-385,-294,-0.044045303740990735,0.010410708156961448
281,"Muscogee County, GA",County or equivalent,191122,196442,5872,30688,19397,11291,5007,-10783,-5776,-0.05641945982147529,0.02619792593212712
282,"Stewart County, GA",County or equivalent,6099,6689,629,448,685,-237,1413,-596,817,-0.09772093785866537,0.23167732415150025
283,"Talbot County, GA",County or equivalent,6883,6143,-749,572,832,-260,0,-493,-493,-0.07162574458811563,0.0
284,"Bartholomew County, IN",County or equivalent,76823,84447,7665,10804,7615,3189,4649,-152,4497,-0.0019785741249365428,0.06051573096598675
285,"Delaware County, OH",County or equivalent,175114,213554,39385,22018,11110,10908,3581,24833,28414,0.1418104777459255,0.020449535731009515
286,"Fairfield County, OH",County or equivalent,146408,159709,13529,17424,13205,4219,1597,7826,9423,0.05345336320419649,0.010907873886672859
287,"Franklin County, OH",County or equivalent,1166218,1324624,161151,189785,96659,93126,59253,8909,68162,0.0076392235413962045,0.05080782495211016
288,"Hocking County, OH",County or equivalent,29483,28095,-1278,3169,3205,-36,47,-1292,-1245,-0.04382186344673202,0.0015941389953532544
289,"Licking County, OH",County or equivalent,166725,178100,11596,20239,16500,3739,1319,6690,8009,0.0401259559154296,0.007911231069125805
290,"Madison County, OH",County or equivalent,43434,44559,1121,4382,4240,142,466,500,966,0.011511718929870608,0.010728922042639408
291,"Morrow County, OH",County or equivalent,34790,35411,586,3897,3319,578,3,18,21,0.0005173900546133947,8.623167576889911e-05
292,"Perry County, OH",County or equivalent,36037,36215,179,4348,3670,678,88,-579,-491,-0.016066820212559313,0.002441934678247357
293,"Pickaway County, OH",County or equivalent,55737,58658,2978,6210,5752,458,143,2408,2551,0.04320289933078565,0.0025656206828498125
294,"Union County, OH",County or equivalent,52462,60021,7687,6649,3778,2871,718,4095,4813,0.07805649803667418,0.01368609660325569
295,"Nueces County, TX",County or equivalent,340251,363148,22925,48668,29349,19319,5890,-2245,3645,-0.0065980702481403435,0.01731075000514326
296,"San Patricio County, TX",County or equivalent,64424,67069,2277,9850,6350,3500,567,-1809,-1242,-0.028079597665466288,0.008801067924996896
297,"Benton County, OR",County or equivalent,85577,93239,7658,7378,5893,1485,4789,1358,6147,0.015868749780899073,0.05596129801231639
298,"Okaloosa County, FL",County or equivalent,180725,212820,31996,27837,17878,9959,4485,17324,21809,0.0958583483192696,0.02481671047171116
299,"Walton County, FL",County or equivalent,55214,76648,21604,7651,6353,1298,305,19775,20080,0.3581519179918137,0.005523961314159453
300,"Allegany County, MD",County or equivalent,74968,70057,-4985,6844,9311,-2467,581,-3085,-2504,-0.04115089104684665,0.007749973321950698
301,"Mineral County, WV",County or equivalent,28208,26722,-1503,2812,3413,-601,40,-929,-889,-0.032933919455473616,0.0014180374361883153
302,"Collin County, TX",County or equivalent,787102,1072069,291175,111337,42343,68994,48737,172435,221172,0.2190757995787077,0.0619195479111983
303,"Dallas County, TX",County or equivalent,2373711,2635888,267732,400126,162249,237877,118769,-87658,31111,-0.036928674130928325,0.050035155922519635
304,"Denton County, TX",County or equivalent,665833,919324,257709,99786,36346,63440,22714,169849,192563,0.25509249316269994,0.034113659130743
305,"Ellis County, TX",County or equivalent,150408,191760,42111,21669,12474,9195,864,32051,32915,0.21309371841923305,0.005744375299186214
306,"Hunt County, TX",County or equivalent,86367,99807,13663,11555,9534,2021,952,10694,11646,0.1238204406775736,0.0110227285884655
307,"Kaufman County, TX",County or equivalent,103880,143198,39846,16490,9595,6895,571,32328,32899,0.3112052368117058,0.005496726992683866
308,"Rockwall County, TX",County or equivalent,78971,109888,31490,10492,5814,4678,1074,25639,26713,0.3246634840637703,0.013599929087893023
309,"Johnson County, TX",County or equivalent,151251,179575,28628,20993,13873,7120,316,21276,21592,0.1406668385663566,0.002089242385174313
310,"Parker County, TX",County or equivalent,117324,148198,31239,14778,11115,3663,735,26789,27524,0.22833350380143874,0.006264702874092257
311,"Tarrant County, TX",County or equivalent,1818167,2123347,312002,284982,128625,156357,61539,94003,155542,0.05170207137188168,0.03384672585081568
312,"Wise County, TX",County or equivalent,59083,71084,12002,7957,5862,2095,240,9676,9916,0.16376961224040756,0.004062082155611597
313,"Murray County, GA",County or equivalent,39532,40032,404,5066,3857,1209,134,-937,-803,-0.02370231711018921,0.0033896590104219365
314,"Whitfield County, GA",County or equivalent,102740,103837,1235,14025,8455,5570,185,-4486,-4301,-0.043663616897021605,0.0018006618649016933
315,"Vermilion County, IL",County or equivalent,81642,74855,-6770,10333,9944,389,253,-7419,-7166,-0.09087234511648416,0.0030988951765022906
316,"Baldwin County, AL",County or equivalent,183121,229287,47024,22965,21613,1352,1618,43683,45301,0.238547190109272,0.008835687878506561
317,"Henry County, IL",County or equivalent,50459,48411,-2076,5388,5531,-143,4,-1926,-1922,-0.03816960304405557,7.92722804653283e-05
318,"Mercer County, IL",County or equivalent,16410,15225,-1211,1497,1911,-414,38,-833,-795,-0.05076173065204144,0.0023156611822059718
319,"Rock Island County, IL",County or equivalent,147613,140907,-6635,18503,16001,2502,3552,-12672,-9120,-0.08584609756593252,0.024062921287420484
320,"Scott County, IA",County or equivalent,165291,173216,7989,22344,15267,7077,2377,-1405,972,-0.008500160323308591,0.014380698283633109
321,"Greene County, OH",County or equivalent,161599,170122,8544,18155,14799,3356,4508,717,5225,0.00443690864423666,0.027896212229036068
322,"Miami County, OH",County or equivalent,102487,107516,5013,12095,11002,1093,708,3315,4023,0.032345565779074416,0.006908193234263857
323,"Montgomery County, OH",County or equivalent,535620,531610,-3589,67812,62126,5686,10735,-19774,-9039,-0.03691796422837086,0.02004219409282701
324,"Lawrence County, AL",County or equivalent,34314,32857,-1451,3678,4209,-531,-25,-885,-910,-0.02579122224165064,-0.0007285656000466282
325,"Morgan County, AL",County or equivalent,119642,119883,364,14608,13259,1349,879,-1801,-922,-0.015053242172481237,0.007346918306280403
326,"Macon County, IL",County or equivalent,110786,103015,-7762,13606,12558,1048,558,-9396,-8838,-0.0848121603812756,0.0050367374939071724
327,"Flagler County, FL",County or equivalent,96065,118451,22760,8357,12998,-4641,1895,25352,27247,0.2639046478946547,0.01972622703377921
328,"Volusia County, FL",County or equivalent,494462,561497,66905,49329,70615,-21286,11785,76137,87922,0.1539794766837492,0.023833985220300044
329,"Adams County, CO",County or equivalent,443692,519883,78182,72249,30148,42101,7861,27733,35594,0.06250507108534749,0.017717245296286613
330,"Arapahoe County, CO",County or equivalent,575124,657452,84975,80049,39016,41033,22594,21119,43713,0.03672077673684284,0.03928544105271211
331,"Broomfield County, CO",County or equivalent,56212,72236,16388,6961,3734,3227,1004,12021,13025,0.21385113498897032,0.0178609549562371
332,"Clear Creek County, CO",County or equivalent,9084,9586,513,718,634,84,189,240,429,0.026420079260237785,0.02080581241743725
333,"Denver County, CO",County or equivalent,603012,735538,136084,94551,45101,49450,18388,66195,84583,0.10977393484706773,0.030493588850636476
334,"Douglas County, CO",County or equivalent,287011,360750,75270,35738,12895,22843,5456,46719,52175,0.16277773325761033,0.019009724365965062
335,"Elbert County, CO",County or equivalent,23137,27313,4229,1956,1373,583,145,3503,3648,0.15140251545144146,0.0062670181959631754
336,"Gilpin County, CO",County or equivalent,5471,6235,786,403,289,114,5,652,657,0.11917382562602814,0.0009139097057210748
337,"Jefferson County, CO",County or equivalent,535567,583283,48451,58907,44010,14897,5714,27652,33366,0.05163126182158348,0.010669066615381455
338,"Park County, CO",County or equivalent,16278,18955,2756,1186,935,251,49,2422,2471,0.14878977761395748,0.00301019781299914
339,"Dallas County, IA",County or equivalent,66751,96963,30824,12508,4519,7989,2319,20293,22612,0.3040104268100852,0.034741052568500845
340,"Guthrie County, IA",County or equivalent,10942,10737,-222,1085,1274,-189,54,-84,-30,-0.007676841528057028,0.0049351124108938035
341,"Jasper County, IA",County or equivalent,36810,37148,306,4219,3917,302,79,-56,23,-0.0015213257267047,0.002146155935886987
342,"Madison County, IA",County or equivalent,15738,16521,840,1720,1539,181,82,579,661,0.03678993518871521,0.005210318973185918
343,"Polk County, IA",County or equivalent,432360,494281,63650,69207,35253,33954,11785,17789,29574,0.04114395411231381,0.027257378110833563
344,"Warren County, IA",County or equivalent,46341,52265,6039,5688,4194,1494,127,4449,4576,0.09600569689907423,0.002740553721326687
345,"Wayne County, MI",County or equivalent,1814847,1740623,-79593,238334,186785,51549,39989,-172894,-132905,-0.0952664329279548,0.02203436432933465
346,"Lapeer County, MI",County or equivalent,88206,87635,-679,8347,8650,-303,554,-912,-358,-0.01033943269165363,0.006280751876289595
347,"Livingston County, MI",County or equivalent,181065,192335,11373,18142,14874,3268,754,7491,8245,0.041371883025432855,0.00416425040731229
348,"Macomb County, MI",County or equivalent,841350,870791,29754,94813,87736,7077,20770,2539,23309,0.003017769061627147,0.024686515718785284
349,"Oakland County, MI",County or equivalent,1203125,1253459,51071,136539,107325,29214,51174,-28562,22612,-0.02373984415584416,0.04253423376623377
350,"St. Clair County, MI",County or equivalent,162688,159293,-3758,16000,17964,-1964,845,-2599,-1754,-0.015975363886703384,0.005193990952006294
351,"Geneva County, AL",County or equivalent,26778,26411,-372,2998,3710,-712,-46,401,355,0.014974979460751362,-0.0017178280678168646
352,"Henry County, AL",County or equivalent,17293,17223,-73,1760,2258,-498,28,411,439,0.02376684207482797,0.0016191522581391314
353,"Houston County, AL",County or equivalent,101800,106580,5018,13519,11212,2307,355,2430,2785,0.023870333988212183,0.0034872298624754423
354,"Kent County, DE",County or equivalent,162972,183643,21291,22616,16251,6365,2840,12086,14926,0.07415997840119776,0.017426306359374616
355,"Dubuque County, IA",County or equivalent,93933,97590,3947,12260,9288,2972,1142,-99,1043,-0.0010539427038421005,0.012157601694825037
356,"Carlton County, MN",County or equivalent,35413,35769,385,3756,3848,-92,78,423,501,0.011944766046367154,0.0022025809730889787
357,"Lake County, MN",County or equivalent,10854,10639,-223,1077,1441,-364,46,103,149,0.009489589091579142,0.00423806891468583
358,"St. Louis County, MN",County or equivalent,200143,198538,-1691,20352,21501,-1149,1410,-1767,-357,-0.008828687488445761,0.007044962851561134
359,"Douglas County, WI",County or equivalent,44137,43702,-458,4391,4340,51,381,-863,-482,-0.019552756190950902,0.00863221333575005
360,"Chatham County, NC",County or equivalent,63845,75748,12262,6512,6940,-428,-1,12619,12618,0.19765055994987865,-1.5662933667475917e-05
361,"Durham County, NC",County or equivalent,271366,327306,57308,43673,20205,23468,15450,18050,33500,0.06651533353478327,0.056934177457750784
362,"Granville County, NC",County or equivalent,57683,60486,2936,5873,5423,450,101,2415,2516,0.04186675450305983,0.0017509491531300385
363,"Orange County, NC",County or equivalent,133985,149077,15385,12291,8180,4111,5994,5249,11243,0.03917602716722021,0.044736351084076566
364,"Person County, NC",County or equivalent,39412,39925,446,4243,4533,-290,27,733,760,0.018598396427484017,0.000685070536892317
365,"Monroe County, PA",County or equivalent,169852,170154,317,14696,14849,-153,2691,-2247,444,-0.01322916421355062,0.015843204672302946
366,"Chippewa County, WI",County or equivalent,62646,64737,2227,7245,5920,1325,71,884,955,0.01411103661845928,0.0011333524885866616
367,"Eau Claire County, WI",County or equivalent,99012,105260,6387,12001,8511,3490,1220,1712,2932,0.01729083343433119,0.01232173877913788
368,"Imperial County, CA",County or equivalent,174704,180267,5745,30275,10616,19659,1371,-15417,-14046,-0.08824640534847514,0.007847559300302226
369,"Hardin County, KY",County or equivalent,106970,111309,5767,15579,9322,6257,2033,-2674,-641,-0.024997662896139104,0.01900532859680284
370,"Larue County, KY",County or equivalent,14181,14431,241,1610,1728,-118,-5,370,365,0.02609124885410056,-0.0003525844439743319
371,"Meade County, KY",County or equivalent,28701,28616,16,2733,2506,227,366,-628,-262,-0.021880770704853492,0.012752168913975124
372,"Elkhart County, IN",County or equivalent,197453,206161,8592,31576,17207,14369,1221,-6923,-5702,-0.03506150830830628,0.006183750056975584
373,"Chemung County, NY",County or equivalent,88895,82622,-6224,9747,9870,-123,464,-6581,-6117,-0.0740311603577254,0.00521964114967096
374,"El Paso County, TX",County or equivalent,803548,841286,40652,132855,53079,79776,16287,-55745,-39458,-0.0693735781807683,0.020268857616470952
375,"Hudspeth County, TX",County or equivalent,3472,4906,1430,429,196,233,503,677,1180,0.1949884792626728,0.1448732718894009
376,"Garfield County, OK",County or equivalent,60771,60869,287,9487,7038,2449,2061,-4200,-2139,-0.06911191193167794,0.03391420249790196
377,"Erie County, PA",County or equivalent,280809,268426,-12160,31336,29490,1846,6147,-20161,-14014,-0.07179613189035965,0.021890324028076023
378,"Lane County, OR",County or equivalent,351948,382986,31281,35750,36152,-402,5562,26261,31823,0.0746161364747065,0.015803470967301992
379,"Posey County, IN",County or equivalent,25861,25275,-637,2813,2526,287,16,-943,-927,-0.03646417385251924,0.0006186922392792235
380,"Vanderburgh County, IN",County or equivalent,179845,182447,2746,22717,19986,2731,1558,-1389,169,-0.0077233173010092014,0.008663015374350136
381,"Warrick County, IN",County or equivalent,59840,63269,3580,6561,5815,746,518,2353,2871,0.039321524064171116,0.008656417112299464
382,"Henderson County, KY",County or equivalent,46263,44740,-1509,5539,5231,308,50,-1834,-1784,-0.0396429111817219,0.001080777295030586
383,"Fairbanks North Star Borough, AK",County or equivalent,98272,95651,-1934,16769,4930,11839,2736,-16675,-13939,-0.16968210680560078,0.027841094106154343
384,"Clay County, MN",County or equivalent,59144,64690,5696,8624,4690,3934,1177,611,1788,0.010330718246990396,0.019900581631272826
385,"Cass County, ND",County or equivalent,150321,183904,34126,25191,10719,14472,6193,13188,19381,0.08773225297862575,0.041198501872659166
386,"San Juan County, NM",County or equivalent,130209,123312,-6733,17580,10400,7180,332,-14320,-13988,-0.10997703691757098,0.00254974694529564
387,"Cumberland County, NC",County or equivalent,327247,336364,16909,57121,25609,31512,13008,-28776,-15768,-0.08793357922303338,0.03974979144193835
388,"Harnett County, NC",County or equivalent,115757,137058,22365,18866,9985,8881,2102,11221,13323,0.09693582245566144,0.01815872906174141
389,"Hoke County, NC",County or equivalent,47498,55830,8941,9373,3418,5955,1266,1657,2923,0.03488567939702724,0.026653753842267043
390,"Benton County, AR",County or equivalent,222601,288774,67426,36510,18040,18470,6524,42137,48661,0.18929384863500165,0.029308044438254993
391,"Madison County, AR",County or equivalent,15686,16644,919,2039,1839,200,91,632,723,0.04029070508733903,0.005801351523651664
392,"Washington County, AR",County or equivalent,204021,243216,40171,32933,15690,17243,5874,16878,22752,0.08272677812578116,0.028791153851809376
393,"Coconino County, AZ",County or equivalent,134624,142481,8046,16520,8280,8240,1828,-2041,-213,-0.015160743998098409,0.01357855954361778
394,"Genesee County, MI",County or equivalent,424959,404794,-20996,49570,46214,3356,2077,-26679,-24602,-0.06278017408738255,0.004887530326455023
395,"Darlington County, SC",County or equivalent,68513,66509,-2091,8012,8697,-685,297,-1658,-1361,-0.024199786901755872,0.0043349437333060886
396,"Florence County, SC",County or equivalent,137161,137588,607,17547,15626,1921,613,-1808,-1195,-0.013181589518886564,0.004469200428693287
397,"Colbert County, AL",County or equivalent,54527,55411,981,6342,7289,-947,399,1578,1977,0.02893979129605517,0.0073174757459607154
398,"Lauderdale County, AL",County or equivalent,92738,93368,659,9473,11416,-1943,526,2146,2672,0.02314046022126852,0.005671892859453514
399,"Fond du Lac County, WI",County or equivalent,101579,102902,1276,11083,9752,1331,1196,-1215,-19,-0.011961133698894457,0.011774087163685408
400,"Larimer County, CO",County or equivalent,300453,360428,60800,34394,22266,12128,4746,43379,48125,0.14437865489777102,0.015796147816796637
401,"Crawford County, AR",County or equivalent,61961,63409,1474,7808,6475,1333,397,-223,174,-0.003599038104614193,0.006407256177272801
402,"Franklin County, AR",County or equivalent,18137,17897,-234,1963,2293,-330,68,35,103,0.00192975685063682,0.00374924188123725
403,"Sebastian County, AR",County or equivalent,125782,127590,1822,17337,13104,4233,813,-3176,-2363,-0.02525003577618419,0.006463563943966545
404,"Sequoyah County, OK",County or equivalent,42513,41538,-892,5432,5490,-58,200,-1021,-821,-0.024016183285112788,0.004704443346740997
405,"Allen County, IN",County or equivalent,355956,382187,26848,53562,32475,21087,6116,-98,6018,-0.00027531492656395737,0.017181898886379214
406,"Whitley County, IN",County or equivalent,33351,34378,1091,3951,3190,761,123,233,356,0.006986297262450901,0.003688045335971935
407,"Fresno County, CA",County or equivalent,932011,1000918,70415,156504,69429,87075,8658,-25041,-16383,-0.026867708642923743,0.009289589929732587
408,"Etowah County, AL",County or equivalent,104440,102371,-2041,12174,14514,-2340,390,-1,389,-9.574875526618153e-06,0.0037342014553810796
409,"Alachua County, FL",County or equivalent,247624,271218,23881,29028,19449,9579,11337,2982,14319,0.012042451458663134,0.04578312279908248
410,"Gilchrist County, FL",County or equivalent,17006,18885,1941,1950,1953,-3,62,1882,1944,0.11066682347406798,0.003645772080442197
411,"Levy County, FL",County or equivalent,40727,42214,1411,4137,5577,-1440,280,2585,2865,0.06347140717460162,0.006875046038254721
412,"Hall County, GA",County or equivalent,180070,206591,26826,26275,14787,11488,1284,14078,15362,0.07818070750263786,0.00713056033764647
413,"Adams County, PA",County or equivalent,101472,102742,1323,10251,10432,-181,594,984,1578,0.009697256385998108,0.005853831598864712
414,"Warren County, NY",County or equivalent,65668,63756,-1942,5874,7148,-1274,315,-941,-626,-0.014329658281050131,0.004796856916610829
415,"Washington County, NY",County or equivalent,63359,60606,-2648,5976,6475,-499,123,-2246,-2123,-0.03544879180542622,0.0019413185182846954
416,"Wayne County, NC",County or equivalent,122891,123967,1302,17091,12485,4606,3040,-6338,-3298,-0.05157415921426305,0.024737368887876247
417,"Polk County, MN",County or equivalent,31639,30900,-700,4215,3470,745,391,-1825,-1434,-0.05768197477796391,0.012358165555169252
418,"Grand Forks County, ND",County or equivalent,66994,69481,2617,10114,5059,5055,1878,-4332,-2454,-0.06466250709018719,0.028032361106964804
419,"Hall County, NE",County or equivalent,58813,61028,2407,9747,5571,4176,2768,-4507,-1739,-0.0766327172563889,0.04706442453199123
420,"Howard County, NE",County or equivalent,6279,6488,214,777,691,86,10,124,134,0.01974836757445453,0.0015926102882624622
421,"Merrick County, NE",County or equivalent,7852,7809,-50,927,880,47,32,-126,-94,-0.016046867040244522,0.004075394803871625
422,"Mesa County, CO",County or equivalent,146266,155603,8867,17901,15037,2864,159,5881,6040,0.040207567035401265,0.001087060560895902
423,"Ionia County, MI",County or equivalent,63847,64553,652,7415,5379,2036,99,-1466,-1367,-0.022961141478847872,0.0015505818597584852
424,"Kent County, MI",County or equivalent,602994,658708,56083,89568,47880,41688,14448,214,14662,0.0003548957369393393,0.02396043741728773
425,"Montcalm County, MI",County or equivalent,63315,63476,134,7357,6286,1071,112,-1047,-935,-0.016536365790097134,0.0017689331122166946
426,"Ottawa County, MI",County or equivalent,264114,294635,30848,33909,19284,14625,4196,12159,16355,0.046036938594697735,0.015887079064343432
427,"Josephine County, OR",County or equivalent,82880,88053,5335,8533,12381,-3848,7,9175,9182,0.11070222007722008,8.445945945945946e-05
428,"Cascade County, MT",County or equivalent,81513,81346,19,11555,8664,2891,940,-3784,-2844,-0.046422043109688026,0.011531902886656115
429,"Weld County, CO",County or equivalent,254224,333983,81147,41936,17551,24385,2635,53627,56262,0.21094389200075525,0.0103648750708037
430,"Brown County, WI",County or equivalent,248474,264610,16604,34053,19879,14174,3240,-603,2637,-0.002426813268189026,0.013039593679821632
431,"Kewaunee County, WI",County or equivalent,20561,20386,-192,2012,1907,105,106,-398,-292,-0.019357035163659355,0.005155391274743446
432,"Oconto County, WI",County or equivalent,37714,38383,726,3751,3706,45,92,618,710,0.01638648777642255,0.002439412419791059
433,"Guilford County, NC",County or equivalent,489626,540521,52066,62777,44013,18764,14198,19335,33533,0.03948932450482613,0.028997643099018436
434,"Randolph County, NC",County or equivalent,141985,144557,2732,16187,15248,939,406,1523,1929,0.010726485192097757,0.0028594569848927704
435,"Rockingham County, NC",County or equivalent,93681,91285,-2378,9449,11717,-2268,116,-157,-41,-0.0016759001291617294,0.0012382446814188574
436,"Pitt County, NC",County or equivalent,168865,182924,14751,21557,12967,8590,1539,4642,6181,0.027489414621147068,0.00911378912148758
437,"Anderson County, SC",County or equivalent,187095,204353,17426,23031,21906,1125,1078,15319,16397,0.08187819022421765,0.005761778775488388
438,"Greenville County, SC",County or equivalent,452688,532486,81303,63928,43017,20911,13455,46648,60103,0.10304668999399144,0.02972245785176545
439,"Laurens County, SC",County or equivalent,66519,67883,1354,7926,8616,-690,456,1631,2087,0.024519310272253042,0.006855184233076264
440,"Pickens County, SC",County or equivalent,119344,127983,8599,12393,12179,214,1951,6438,8389,0.05394489877999732,0.016347700764177502
441,"Hancock County, MS",County or equivalent,44102,48000,3963,4887,4959,-72,133,3893,4026,0.08827264069656705,0.003015736247789216
442,"Harrison County, MS",County or equivalent,187868,208801,21692,28039,20203,7836,2993,10884,13877,0.05793429429173675,0.015931398641599422
443,"Jackson County, MS",County or equivalent,139479,143802,4133,16590,13987,2603,2719,-1140,1579,-0.008173273395995096,0.01949397400325497
444,"Stone County, MS",County or equivalent,17907,18360,570,2193,1869,324,36,187,223,0.010442843580722623,0.002010386999497403
445,"Washington County, MD",County or equivalent,147727,151146,3730,17513,15739,1774,1858,162,2020,0.0010966174091398325,0.012577253988776595
446,"Berkeley County, WV",County or equivalent,104638,122125,17929,14274,10272,4002,321,13518,13839,0.12918824901087558,0.003067719184235173
447,"Morgan County, WV",County or equivalent,17492,17873,332,1430,2276,-846,29,1159,1188,0.06625886119368854,0.0016579007546306886
448,"Tangipahoa Parish, LA",County or equivalent,121463,136765,15682,19674,12629,7045,799,7836,8635,0.06451347323876408,0.0065781349052797975
449,"Kings County, CA",County or equivalent,152342,152692,-298,23918,8594,15324,515,-16507,-15992,-0.10835488571766158,0.00338055165351643
450,"Cumberland County, PA",County or equivalent,235903,255857,20454,26295,23830,2465,5769,12381,18150,0.05248343598852071,0.02445496666002552
451,"Dauphin County, PA",County or equivalent,268289,279874,11747,35079,25907,9172,9779,-7087,2692,-0.026415544431564467,0.036449500352232114
452,"Perry County, PA",County or equivalent,45920,46212,285,5477,4656,821,112,-625,-513,-0.013610627177700348,0.0024390243902439024
453,"Rockingham County, VA",County or equivalent,76413,82346,6022,9060,7434,1626,818,3656,4474,0.04784526193187024,0.010704984753903132
454,"Harrisonburg city, VA",County or equivalent,48999,53204,4302,5742,2889,2853,4287,-2892,1395,-0.059021612685973175,0.08749158146084614
455,"Hartford County, CT",County or equivalent,895214,889226,-4790,96172,82497,13675,43009,-61655,-18646,-0.06887180048569393,0.04804326116436964
456,"Middlesex County, CT",County or equivalent,165624,161657,-4016,13875,15674,-1799,2860,-4997,-2137,-0.03017074820074385,0.017268028788098345
457,"Tolland County, CT",County or equivalent,153242,150600,-2145,11859,10770,1089,4045,-7369,-3324,-0.04808733898017515,0.026396157711332403
458,"Covington County, MS",County or equivalent,19578,18518,-1055,2648,2704,-56,22,-1015,-993,-0.05184390642557973,0.0011237102870569006
459,"Forrest County, MS",County or equivalent,74944,75009,150,10856,7680,3176,1321,-4379,-3058,-0.05843029461998293,0.017626494449188727
460,"Lamar County, MS",County or equivalent,56109,64165,8433,8012,4337,3675,260,4453,4713,0.07936338198862927,0.004633837708745477
461,"Perry County, MS",County or equivalent,12235,11862,-390,1455,1387,68,-8,-450,-458,-0.03677973028197793,-0.0006538618716796077
462,"Alexander County, NC",County or equivalent,37232,37441,259,3626,3909,-283,49,519,568,0.013939621830683284,0.0013160721959604642
463,"Burke County, NC",County or equivalent,90567,90418,-406,8979,10637,-1658,754,546,1300,0.006028685945211832,0.008325328210054436
464,"Caldwell County, NC",County or equivalent,83025,82100,-959,8262,9807,-1545,497,154,651,0.0018548629930743754,0.005986148750376392
465,"Catawba County, NC",County or equivalent,154758,160307,5565,17727,16881,846,1790,3041,4831,0.019650034247017924,0.01156644567647553
466,"Beaufort County, SC",County or equivalent,162843,195656,33437,20505,15673,4832,4212,24131,28343,0.14818567577359787,0.025865404100882446
467,"Jasper County, SC",County or equivalent,24949,31588,6797,3559,2493,1066,534,5152,5686,0.20650126257565435,0.02140366347348591
468,"Liberty County, GA",County or equivalent,62772,63004,-580,14611,3596,11015,2635,-14646,-12011,-0.23332058879755305,0.041977314726311096
469,"Long County, GA",County or equivalent,14575,20171,5826,2674,958,1716,290,3750,4040,0.2572898799313893,0.019897084048027446
470,"Citrus County, FL",County or equivalent,141177,153010,11781,10688,25947,-15259,608,26447,27055,0.18733221417086351,0.004306650516727229
471,"Garland County, AR",County or equivalent,96080,99789,3786,11205,14174,-2969,176,6616,6792,0.06885928393005829,0.0018318068276436306
472,"Lafourche Parish, LA",County or equivalent,96693,97596,1005,12489,9160,3329,1057,-3338,-2281,-0.034521630314500534,0.010931504865915835
473,"Terrebonne Parish, LA",County or equivalent,111552,109859,-1730,16435,10758,5677,725,-8112,-7387,-0.07271944922547333,0.0064992111302352275
474,"Austin County, TX",County or equivalent,28372,29972,1551,3470,2872,598,222,746,968,0.02629352883124207,0.00782461581841252
475,"Brazoria County, TX",County or equivalent,314499,380518,67332,48335,23392,24943,4604,37589,42193,0.11952025284659093,0.014639156245329871
476,"Chambers County, TX",County or equivalent,35452,45590,10487,5309,2852,2457,468,7534,8002,0.21251269321900035,0.013200947760352024
477,"Fort Bend County, TX",County or equivalent,590177,839706,255074,92628,31474,61154,48523,143926,192449,0.2438692121177206,0.08221770756908521
478,"Galveston County, TX",County or equivalent,292492,345089,53771,41027,27118,13909,5059,34495,39554,0.11793484950015727,0.017296199554175842
479,"Harris County, TX",County or equivalent,4107542,4738253,645144,704169,261529,442640,284632,-82035,202597,-0.019971798218983518,0.06929497008186404
480,"Liberty County, TX",County or equivalent,75870,91547,15890,11583,8020,3563,333,12033,12366,0.15860023724792408,0.0043890865954922895
481,"Montgomery County, TX",County or equivalent,459223,626351,170611,71546,37044,34502,13068,121948,135016,0.2655529013137408,0.028456762836356193
482,"Waller County, TX",County or equivalent,43558,57452,14133,6391,3196,3195,407,10461,10868,0.2401625418981588,0.00934386335460765
483,"Boyd County, KY",County or equivalent,49602,46516,-3017,5752,6326,-574,17,-2442,-2425,-0.049231885811056,0.00034272811580178216
484,"Carter County, KY",County or equivalent,27739,26542,-1174,3529,3318,211,76,-1448,-1372,-0.05220087241789538,0.0027398247954143985
485,"Greenup County, KY",County or equivalent,36889,34865,-2045,3876,4819,-943,-3,-1079,-1082,-0.02924991189785573,-8.132505624983057e-05
486,"Lawrence County, OH",County or equivalent,62428,59091,-3360,6889,8052,-1163,-107,-2064,-2171,-0.0330620875248286,-0.0017139744986224132
487,"Cabell County, WV",County or equivalent,96282,91589,-4657,11327,12508,-1181,786,-4195,-3409,-0.0435699299972996,0.008163519660995825
488,"Putnam County, WV",County or equivalent,55620,56428,940,5822,5945,-123,139,959,1098,0.017241999280834232,0.002499101042790364
489,"Wayne County, WV",County or equivalent,42501,39054,-3488,4081,5232,-1151,86,-2412,-2326,-0.05675160584456836,0.002023481800428225
490,"Limestone County, AL",County or equivalent,83168,102228,19453,10346,7963,2383,527,16449,16976,0.19778039630627164,0.006336571758368603
491,"Madison County, AL",County or equivalent,336114,379453,44641,42947,31108,11839,4802,28090,32892,0.08357283540703453,0.014286819352957628
492,"Bonneville County, ID",County or equivalent,104682,122134,17840,19476,8615,10861,419,6616,7035,0.0632009323474905,0.004002598345465314
493,"Butte County, ID",County or equivalent,2914,2646,-247,285,280,5,-2,-255,-257,-0.0875085792724777,-0.0006863417982155112
494,"Jefferson County, ID",County or equivalent,26222,30581,4437,4839,1615,3224,80,1132,1212,0.043169857371672636,0.0030508733124856987
495,"Boone County, IN",County or equivalent,56924,69347,12700,7756,5207,2549,666,9429,10095,0.16564190850959173,0.01169981027334692
496,"Brown County, IN",County or equivalent,15210,15112,-135,1195,1619,-424,-11,310,299,0.02038132807363576,-0.0007232084155161077
497,"Hamilton County, IN",County or equivalent,276499,344238,69683,39281,16783,22498,6720,40260,46980,0.14560631322355594,0.024303885366674025
498,"Hancock County, IN",County or equivalent,70246,79553,9493,8069,6537,1532,108,7898,8006,0.1124334481678672,0.001537454089912593
499,"Hendricks County, IN",County or equivalent,145954,173251,27796,17624,11436,6188,2225,19409,21634,0.1329802540526467,0.015244529098209026
500,"Johnson County, IN",County or equivalent,140269,160607,20751,18935,13201,5734,2370,12691,15061,0.09047615652781442,0.01689610676628478
501,"Madison County, IN",County or equivalent,131621,129681,-1958,15091,15437,-346,565,-2109,-1544,-0.01602327896004437,0.0042926280760668895
502,"Marion County, IN",County or equivalent,904604,966183,62810,146841,82135,64706,34407,-35740,-1333,-0.03950900062347724,0.03803542765674262
503,"Morgan County, IN",County or equivalent,69138,70707,1781,7893,6949,944,388,507,895,0.007333159767421678,0.005611964476843414
504,"Putnam County, IN",County or equivalent,37903,37469,-472,3726,3640,86,402,-957,-555,-0.0252486610558531,0.010606020631612274
505,"Shelby County, IN",County or equivalent,44295,44871,492,5145,4690,455,269,-205,64,-0.004628061857997517,0.006072920194152839
506,"Johnson County, IA",County or equivalent,131344,153740,22858,18276,7217,11059,9768,2018,11786,0.015364234376903397,0.0743695943476672
507,"Washington County, IA",County or equivalent,21687,21992,289,2988,2490,498,156,-348,-192,-0.01604647945773966,0.007193249412090192
508,"Tompkins County, NY",County or equivalent,101743,101058,-523,8432,6996,1436,7057,-9079,-2022,-0.08923464022094886,0.06936103712294703
509,"Jackson County, MI",County or equivalent,160109,156920,-3313,18145,17154,991,830,-5048,-4218,-0.03152852119493595,0.0051839684215128435
510,"Copiah County, MS",County or equivalent,29436,27933,-1518,3736,3339,397,198,-2107,-1909,-0.07157901888843593,0.006726457399103139
511,"Hinds County, MS",County or equivalent,245717,227966,-17394,33056,22012,11044,2174,-30740,-28566,-0.12510326920807271,0.008847576683745936
512,"Holmes County, MS",County or equivalent,19406,16726,-2757,2598,2254,344,-1,-3120,-3121,-0.16077501803565908,-5.153045449860868e-05
513,"Madison County, MS",County or equivalent,95546,106871,11663,13349,10353,2996,1278,7356,8634,0.07698909425826303,0.013375756180269191
514,"Rankin County, MS",County or equivalent,142518,155975,13926,18796,11635,7161,836,5977,6813,0.04193856214653588,0.005865925707629913
515,"Simpson County, MS",County or equivalent,27527,26629,-871,3323,3125,198,123,-1175,-1052,-0.04268536346132888,0.00446834017510081
516,"Yazoo County, MS",County or equivalent,28135,26982,-1083,3496,3024,472,467,-2037,-1570,-0.07240092411586993,0.016598542740358983
517,"Chester County, TN",County or equivalent,17194,17432,287,1901,1873,28,49,216,265,0.012562521809933698,0.002849831336512737
518,"Crockett County, TN",County or equivalent,14589,14180,-395,1726,1868,-142,77,-320,-243,-0.021934334087326063,0.0052779491397628355
519,"Gibson County, TN",County or equivalent,49733,49159,-527,6152,6928,-776,57,228,285,0.004584481129230089,0.0011461202823075222
520,"Madison County, TN",County or equivalent,98251,98360,58,12708,10201,2507,638,-3047,-2409,-0.03101240699840205,0.006493572584502957
521,"Baker County, FL",County or equivalent,27067,29566,2451,3521,2532,989,75,1391,1466,0.05139099272176451,0.002770901836184284
522,"Clay County, FL",County or equivalent,191453,221770,30898,22080,17476,4604,3560,22797,26357,0.11907361075564238,0.018594642027024908
523,"Duval County, FL",County or equivalent,865653,966728,102475,131243,82659,48584,32583,21623,54206,0.024978831009653986,0.037639793312100815
524,"Nassau County, FL",County or equivalent,73526,91113,17799,8159,8402,-243,380,17618,17998,0.2396159181786035,0.005168239806327014
525,"St. Johns County, FL",County or equivalent,191268,278715,88675,21247,18957,2290,2194,83535,85729,0.4367432084823389,0.011470815818641905
526,"Onslow County, NC",County or equivalent,186918,203943,26142,42537,11014,31523,7933,-14518,-6585,-0.07767042232422773,0.0424410704159043
527,"Rock County, WI",County or equivalent,160261,163084,2757,19706,15320,4386,444,-1981,-1537,-0.012361085978497577,0.0027704806534340856
528,"Callaway County, MO",County or equivalent,44312,44887,556,5118,4045,1073,241,-736,-495,-0.016609496298970933,0.005438707347896732
529,"Cole County, MO",County or equivalent,76145,76191,221,9318,6707,2611,838,-3198,-2360,-0.041998818044520325,0.011005318799658546
530,"Moniteau County, MO",County or equivalent,15630,15585,-25,2084,1518,566,76,-656,-580,-0.04197056941778631,0.004862444017914268
531,"Osage County, MO",County or equivalent,13907,13535,-376,1539,1353,186,8,-572,-564,-0.041130366002732434,0.0005752498741640902
532,"Carter County, TN",County or equivalent,57343,56418,-965,5195,7294,-2099,58,1114,1172,0.01942695708281743,0.001011457370559615
533,"Unicoi County, TN",County or equivalent,18283,17755,-556,1626,2824,-1198,166,495,661,0.02707433134605918,0.009079472734233988
534,"Washington County, TN",County or equivalent,123393,130367,7304,13325,14366,-1041,1547,6812,8359,0.055205724798003133,0.012537177959851856
535,"Cambria County, PA",County or equivalent,143458,128672,-15021,13450,18963,-5513,473,-10027,-9554,-0.06989502153940526,0.003297132261707259
536,"Craighead County, AR",County or equivalent,96751,112245,15802,15141,9517,5624,1435,8720,10155,0.0901282674080888,0.014831888042500853
537,"Poinsett County, AR",County or equivalent,24510,23283,-1287,3128,3516,-388,94,-980,-886,-0.03998368013055895,0.003835169318645451
538,"Jasper County, MO",County or equivalent,117662,121648,4253,16948,12274,4674,1242,-1606,-364,-0.01364926654314902,0.01055565943125223
539,"Newton County, MO",County or equivalent,58172,58451,337,7403,6503,900,161,-697,-536,-0.011981709413463522,0.002767654541703913
540,"Maui County, HI",County or equivalent,155025,167902,13062,19797,12199,7598,6714,-1183,5531,-0.0076310272536687625,0.043309143686502176
541,"Kalamazoo County, MI",County or equivalent,250754,265988,15661,31878,21796,10082,5213,531,5744,0.002117613278352489,0.02078929947279006
542,"Kankakee County, IL",County or equivalent,113420,108594,-4856,13470,11623,1847,488,-7210,-6722,-0.0635690354434844,0.004302592135425851
543,"Johnson County, KS",County or equivalent,545681,607220,63039,74925,39136,35789,11818,15804,27622,0.02896197595298352,0.02165734192687669
544,"Leavenworth County, KS",County or equivalent,76536,82246,6026,10016,6171,3845,1160,1059,2219,0.013836625901536531,0.015156266332183546
545,"Linn County, KS",County or equivalent,9624,9654,-2,1008,1181,-173,5,165,170,0.017144638403990026,0.0005195344970906068
546,"Miami County, KS",County or equivalent,32882,34334,1553,3744,2946,798,74,681,755,0.02071041907426556,0.0022504713825193113
547,"Wyandotte County, KS",County or equivalent,157636,165265,7742,27465,14252,13213,5996,-11353,-5357,-0.07202035068131643,0.03803699662513639
548,"Bates County, MO",County or equivalent,17026,16242,-805,1902,2152,-250,19,-581,-562,-0.03412428051215788,0.0011159403265593797
549,"Caldwell County, MO",County or equivalent,9428,9051,-367,972,1052,-80,12,-306,-294,-0.032456512515910065,0.0012728044123886295
550,"Cass County, MO",County or equivalent,99756,106806,7306,12104,9656,2448,204,4731,4935,0.04742571875375917,0.002044989775051125
551,"Clay County, MO",County or equivalent,222649,253463,31558,31494,17779,13715,1988,15890,17878,0.07136793787531047,0.008928852139466155
552,"Clinton County, MO",County or equivalent,20740,20553,-189,2343,2557,-214,-27,49,22,0.0023625843780135003,-0.0013018322082931533
553,"Jackson County, MO",County or equivalent,674854,705925,31761,96051,64671,31380,8464,-7553,911,-0.011192050428685315,0.012541972041360058
554,"Lafayette County, MO",County or equivalent,33380,33006,-363,3863,3898,-35,19,-339,-320,-0.010155781905332534,0.0005692031156381066
555,"Platte County, MO",County or equivalent,89714,106532,17201,12087,6851,5236,2137,9836,11973,0.10963729183850904,0.02382013955458457
556,"Ray County, MO",County or equivalent,23517,22915,-601,2596,2628,-32,13,-585,-572,-0.02487562189054726,0.000552791597567717
557,"Benton County, WA",County or equivalent,176467,206426,31258,26683,14219,12464,2792,16031,18823,0.0908441804983368,0.015821655040319155
558,"Franklin County, WA",County or equivalent,79076,97075,18915,16633,4007,12626,1382,4794,6176,0.060625221306085275,0.01747685770651019
559,"Bell County, TX",County or equivalent,312886,369927,59749,63382,21854,41528,11369,6558,17927,0.020959710565509482,0.03633591787424174
560,"Coryell County, TX",County or equivalent,75654,76737,1262,10016,4649,5367,2891,-7165,-4274,-0.09470748407222354,0.03821344542258175
561,"Lampasas County, TX",County or equivalent,19759,21789,2115,2291,2095,196,204,1718,1922,0.08694772002631712,0.010324409130016702
562,"Hawkins County, TN",County or equivalent,56870,56775,-51,5515,7314,-1799,144,1649,1793,0.028995955688412168,0.002532090733251275
563,"Sullivan County, TN",County or equivalent,156756,158755,1951,15754,21106,-5352,165,7282,7447,0.04645436219347266,0.001052591288371737
564,"Scott County, VA",County or equivalent,23127,21629,-1537,1833,2981,-1148,17,-391,-374,-0.01690664591170494,0.0007350715613784754
565,"Washington County, VA",County or equivalent,54966,53695,-1264,4739,6391,-1652,118,297,415,0.005403340246697959,0.002146781646836226
566,"Bristol city, VA",County or equivalent,17769,17329,-409,1981,2498,-517,23,91,114,0.005121278631324216,0.0012943891046204065
567,"Ulster County, NY",County or equivalent,182422,177716,-4806,16083,17416,-1333,2613,-6042,-3429,-0.03312100514192367,0.014323930227713763
568,"Anderson County, TN",County or equivalent,75088,77558,2486,8237,9799,-1562,459,3661,4120,0.04875612614532282,0.006112827615597699
569,"Blount County, TN",County or equivalent,123208,134751,11650,12989,14137,-1148,661,12182,12843,0.09887344977598857,0.005364911369391598
570,"Campbell County, TN",County or equivalent,40735,39837,-885,4431,5878,-1447,59,534,593,0.013109119921443476,0.0014483859089235301
571,"Knox County, TN",County or equivalent,432952,475609,43350,53357,44871,8486,6063,28822,34885,0.0665708900755742,0.014003861859975241
572,"Loudon County, TN",County or equivalent,48719,54910,6341,5341,6519,-1178,400,7084,7484,0.14540528335967487,0.008210349145097395
573,"Morgan County, TN",County or equivalent,22028,21431,-564,2040,2440,-400,11,-175,-164,-0.007944434356273834,0.0004993644452514982
574,"Roane County, TN",County or equivalent,54173,53841,-368,4849,7469,-2620,-59,2358,2299,0.043527218356007605,-0.0010891034279068908
575,"Union County, TN",County or equivalent,19118,20187,1079,2127,2224,-97,0,1181,1181,0.061774244167799974,0.0
576,"Howard County, IN",County or equivalent,82753,82732,-16,10165,10109,56,546,-560,-14,-0.0067671262673256564,0.006597948110642514
577,"Houston County, MN",County or equivalent,19027,18632,-388,1964,1777,187,78,-650,-572,-0.03416198034372208,0.00409943764124665
578,"La Crosse County, WI",County or equivalent,114879,118502,3862,12562,10274,2288,535,1081,1616,0.009409900852201012,0.004657073964780334
579,"Acadia Parish, LA",County or equivalent,61876,61918,130,8915,6752,2163,370,-2364,-1994,-0.038205443144353216,0.00597970133816019
580,"Iberia Parish, LA",County or equivalent,72882,68991,-3865,10511,7558,2953,740,-7552,-6812,-0.10361954940863312,0.010153398644384071
581,"Lafayette Parish, LA",County or equivalent,222513,246518,24548,33829,18199,15630,3240,5613,8853,0.025225492443138157,0.014560947000849391
582,"St. Martin Parish, LA",County or equivalent,52263,52954,794,7304,4985,2319,397,-1896,-1499,-0.03627805522071064,0.00759619616172053
583,"Vermilion Parish, LA",County or equivalent,58083,59378,1420,7992,5820,2172,267,-977,-710,-0.016820756503624124,0.004596869996384484
584,"Benton County, IN",County or equivalent,8863,8741,-95,1102,880,222,22,-343,-321,-0.03870021437436534,0.002482229493399526
585,"Carroll County, IN",County or equivalent,20200,20228,68,2179,1910,269,106,-306,-200,-0.015148514851485146,0.005247524752475248
586,"Tippecanoe County, IN",County or equivalent,173105,196115,23314,23037,12174,10863,16003,-3503,12500,-0.020236272782415292,0.0924467808555501
587,"Warren County, IN",County or equivalent,8521,8194,-317,878,810,68,23,-409,-386,-0.047999061143058325,0.002699213707311349
588,"Calcasieu Parish, LA",County or equivalent,193023,203310,10543,29234,20540,8694,1723,268,1991,0.0013884355750350993,0.00892639737233387
589,"Cameron Parish, LA",County or equivalent,6915,7003,135,710,516,194,-22,-42,-64,-0.006073752711496746,-0.0031814895155459146
590,"Mohave County, AZ",County or equivalent,200336,217206,17025,18687,30248,-11561,-596,29164,28568,0.14557543327210287,-0.0029750019966456355
591,"Polk County, FL",County or equivalent,603119,744552,142484,77998,68161,9837,24844,107693,132537,0.1785601183182755,0.04119253414334485
592,"Lancaster County, PA",County or equivalent,520325,546192,26749,72008,50889,21119,12129,-6073,6056,-0.011671551434199779,0.023310430980637103
593,"Clinton County, MI",County or equivalent,75400,79753,4391,8252,6239,2013,801,1615,2416,0.021419098143236073,0.010623342175066313
594,"Eaton County, MI",County or equivalent,107745,110148,2389,11816,10331,1485,1491,-508,983,-0.004714835955264746,0.013838229152164832
595,"Ingham County, MI",County or equivalent,281122,290609,9714,33036,21655,11381,17153,-18962,-1809,-0.06745114220872077,0.06101621360121229
596,"Shiawassee County, MI",County or equivalent,70635,67738,-2933,7181,7450,-269,100,-2776,-2676,-0.03930062999929214,0.0014157287463721954
597,"Webb County, TX",County or equivalent,251358,277681,27377,53126,13615,39511,7248,-19382,-12134,-0.07710914313449344,0.02883536629031103
598,"DoÒa Ana County, NM",County or equivalent,210096,221262,12050,29575,15857,13718,2984,-4693,-1709,-0.022337407661259613,0.014203030995354504
599,"Clark County, NV",County or equivalent,1952640,2315963,364685,274679,161068,113611,35102,214942,250044,0.11007763847918717,0.017976687971156997
600,"Douglas County, KS",County or equivalent,111204,122530,11704,12245,7120,5125,5493,1112,6605,0.009999640300708608,0.049395705190460784
601,"Comanche County, OK",County or equivalent,125401,121099,-2994,18928,10634,8294,3231,-14754,-11523,-0.11765456415818056,0.02576534477396512
602,"Cotton County, OK",County or equivalent,6167,5676,-510,668,830,-162,7,-352,-345,-0.057077995784011674,0.0011350737797956867
603,"Lebanon County, PA",County or equivalent,133667,141663,8067,16592,15185,1407,4961,1821,6782,0.013623407422924132,0.03711462066179386
604,"Nez Perce County, ID",County or equivalent,39317,40755,1485,4841,5148,-307,138,1681,1819,0.0427550423480937,0.0035099320904443372
605,"Asotin County, WA",County or equivalent,21725,22820,1197,2401,2548,-147,-88,1436,1348,0.06609896432681242,-0.0040506329113924044
606,"Androscoggin County, ME",County or equivalent,107712,108547,834,13026,11262,1764,1566,-2456,-890,-0.02280154486036839,0.014538770053475937
607,"Bourbon County, KY",County or equivalent,19965,19901,-107,2256,2266,-10,130,-209,-79,-0.01046831955922865,0.006511394941147007
608,"Clark County, KY",County or equivalent,35599,36463,864,4356,4250,106,56,718,774,0.020169105873760498,0.0015730778954465012
609,"Fayette County, KY",County or equivalent,296868,324735,28860,40858,23705,17153,11492,296,11788,0.0009970761415848124,0.03871080749693467
610,"Jessamine County, KY",County or equivalent,48682,54057,5478,6724,4573,2151,845,2484,3329,0.05102501951439957,0.017357544883119018
611,"Scott County, KY",County or equivalent,47271,58470,11381,6893,3793,3100,411,7805,8216,0.16511180216200208,0.008694548454655074
612,"Woodford County, KY",County or equivalent,25040,26765,1820,2873,2418,455,95,1286,1381,0.051357827476038335,0.003793929712460064
613,"Allen County, OH",County or equivalent,106342,101980,-4315,12966,11420,1546,366,-6231,-5865,-0.058593970397397076,0.003441725752759963
614,"Lancaster County, NE",County or equivalent,286175,320650,35243,40935,21669,19266,8871,7194,16065,0.025138464226434874,0.030998514894732244
615,"Seward County, NE",County or equivalent,16800,17186,436,1961,1742,219,103,120,223,0.0071428571428571435,0.006130952380952381
616,"Faulkner County, AR",County or equivalent,114035,126919,13677,15679,9461,6218,1291,6102,7393,0.05350988731529793,0.011321085631604331
617,"Grant County, AR",County or equivalent,17887,18449,607,1940,1952,-12,17,609,626,0.03404707329345335,0.0009504109129535416
618,"Lonoke County, AR",County or equivalent,68739,73921,5546,9620,6700,2920,733,1927,2660,0.028033576281295918,0.010663524345713495
619,"Perry County, AR",County or equivalent,10445,10327,-117,1103,1301,-198,9,80,89,0.007659167065581619,0.000861656294877932
620,"Pulaski County, AR",County or equivalent,383569,392980,10228,55589,37508,18081,6457,-14066,-7609,-0.03667136812411848,0.0168339985765273
621,"Saline County, AR",County or equivalent,107651,123968,16842,13684,11063,2621,534,13595,14129,0.1262877260777884,0.004960474124717838
622,"Franklin County, ID",County or equivalent,12782,14215,1429,2047,1046,1001,-67,495,428,0.0387263339070568,-0.005241746205601627
623,"Cache County, UT",County or equivalent,113388,130004,17348,23488,5499,17989,2698,-3365,-667,-0.029676861749038694,0.023794405051680952
624,"Gregg County, TX",County or equivalent,122044,124229,2422,18439,13200,5239,1428,-4209,-2781,-0.03448756186293468,0.011700698108878764
625,"Harrison County, TX",County or equivalent,65770,66386,747,8279,6695,1584,643,-1457,-814,-0.022152957275353505,0.009776493842177285
626,"Rusk County, TX",County or equivalent,53307,54324,1069,6297,5675,622,44,401,445,0.007522464216706998,0.0008254075449753317
627,"Upshur County, TX",County or equivalent,39372,42166,2862,4810,4661,149,157,2577,2734,0.06545260591283146,0.003987605404856243
628,"Cowlitz County, WA",County or equivalent,102358,111371,8963,12585,11610,975,241,7775,8016,0.07595888938822562,0.0023544813302331037
629,"Orange County, CA",County or equivalent,3016376,3166857,156599,382227,200199,182028,81608,-104701,-23093,-0.03471085832800685,0.027054982535333796
630,"Los Angeles County, CA",County or equivalent,9821647,9943046,124400,1256001,639278,616723,277336,-767079,-489743,-0.07810085212795778,0.02823721927697055
631,"Clark County, IN",County or equivalent,110572,119266,9045,14825,12174,2651,664,5735,6399,0.05186665701986036,0.006005136924356979
632,"Floyd County, IN",County or equivalent,74706,78936,4361,9055,7826,1229,357,2817,3174,0.03770781463336279,0.004778732631917115
633,"Harrison County, IN",County or equivalent,39328,40682,1319,4358,4015,343,168,830,998,0.021104556550040683,0.004271765663140765
634,"Washington County, IN",County or equivalent,28297,28213,-47,3215,3150,65,9,-111,-102,-0.003922677315616497,0.0003180549174824186
635,"Bullitt County, KY",County or equivalent,74483,82182,7889,8022,6086,1936,63,5877,5940,0.07890391095954781,0.0008458305922156733
636,"Henry County, KY",County or equivalent,15372,16067,656,1805,1828,-23,51,635,686,0.041308873276086386,0.003317720530835285
637,"Jefferson County, KY",County or equivalent,742096,767452,26357,101330,79480,21850,20560,-15397,5163,-0.020747989478450232,0.02770531036415774
638,"Oldham County, KY",County or equivalent,60441,66999,6643,5627,4095,1532,305,4818,5123,0.07971410135504045,0.0050462434440197886
639,"Shelby County, KY",County or equivalent,42222,49611,7607,6024,3697,2327,861,4402,5263,0.10425844346549193,0.02039221259059258
640,"Spencer County, KY",County or equivalent,17167,19585,2477,1959,1435,524,31,1923,1954,0.11201724238364304,0.001805790178831479
641,"Crosby County, TX",County or equivalent,6025,5567,-489,773,736,37,21,-550,-529,-0.0912863070539419,0.0034854771784232365
642,"Lubbock County, TX",County or equivalent,280332,314772,35826,41349,24825,16524,3998,15231,19229,0.05433200633534523,0.014261661173180371
643,"Lynn County, TX",County or equivalent,5912,6025,110,751,567,184,5,-83,-78,-0.014039242219215157,0.0008457374830852502
644,"Amherst County, VA",County or equivalent,32389,31667,-687,3363,3609,-246,103,-551,-448,-0.017011948501034303,0.003180092006545432
645,"Appomattox County, VA",County or equivalent,15091,16043,1021,1870,1782,88,68,870,938,0.057650255118945073,0.0045059969518255905
646,"Bedford County, VA",County or equivalent,75032,79811,4883,7442,8016,-574,455,5048,5503,0.06727796140313466,0.006064079326154174
647,"Campbell County, VA",County or equivalent,54910,55304,489,6120,5716,404,600,-477,123,-0.00868694226916773,0.010926971407758149
648,"Lynchburg city, VA",County or equivalent,75553,81561,6026,10312,8350,1962,3169,909,4078,0.01203128929360846,0.04194406575516525
649,"Bibb County, GA",County or equivalent,155878,152737,-3107,21880,17004,4876,1674,-9662,-7988,-0.06198437239379515,0.010739167810723772
650,"Crawford County, GA",County or equivalent,12577,12231,-362,1300,1320,-20,52,-396,-344,-0.03148604595690546,0.004134531287270414
651,"Jones County, GA",County or equivalent,28628,28787,139,2999,2730,269,18,-145,-127,-0.005064971356713707,0.0006287550649713567
652,"Monroe County, GA",County or equivalent,26133,28042,1921,2766,2864,-98,29,2012,2041,0.07699077794359623,0.001109708031990204
653,"Twiggs County, GA",County or equivalent,8983,8103,-932,901,1154,-253,130,-819,-689,-0.09117221418234443,0.01447178002894356
654,"Madera County, CA",County or equivalent,151006,157761,6927,22963,11118,11845,-1062,-3930,-4992,-0.026025455942147998,-0.007032833132458313
655,"Columbia County, WI",County or equivalent,56854,57668,812,6155,5569,586,222,34,256,0.0005980230062968305,0.003904738452879305
656,"Dane County, WI",County or equivalent,489247,552536,64445,61742,33061,28681,17320,18459,35779,0.037729408662700026,0.035401341244810904
657,"Green County, WI",County or equivalent,36858,36603,-236,3843,3567,276,259,-748,-489,-0.02029410168755765,0.007026968365076781
658,"Iowa County, WI",County or equivalent,23694,23640,-51,2699,2112,587,52,-677,-625,-0.028572634422216595,0.002194648434202752
659,"Hillsborough County, NH",County or equivalent,401064,418735,18029,43670,33432,10238,15626,-7656,7970,-0.01908922266770391,0.03896136277501845
660,"Geary County, KS",County or equivalent,35241,32218,-2134,10154,2108,8046,1772,-12170,-10398,-0.34533639794557475,0.05028234159076076
661,"Pottawatomie County, KS",County or equivalent,21729,24722,3114,3751,1800,1951,115,1059,1174,0.04873671130746928,0.005292466289290809
662,"Riley County, KS",County or equivalent,71557,73202,2068,10266,3624,6642,6389,-11244,-4855,-0.15713347401372332,0.08928546473440753
663,"Blue Earth County, MN",County or equivalent,64091,68241,4228,7544,4961,2583,1293,366,1659,0.0057106301976876635,0.020174439468880187
664,"Nicollet County, MN",County or equivalent,32758,34482,1753,3843,2396,1447,405,-93,312,-0.00283900116002198,0.012363392148482814
665,"Richland County, OH",County or equivalent,124156,120891,-3581,14214,14524,-310,365,-3612,-3247,-0.029092432101549662,0.0029398498662972393
666,"Hidalgo County, TX",County or equivalent,779091,875200,100466,157532,42913,114619,10261,-24274,-14013,-0.031156822502121064,0.013170476876257074
667,"Jackson County, OR",County or equivalent,203357,221844,18638,23394,23882,-488,156,18974,19130,0.09330389413691194,0.0007671238265710056
668,"Crittenden County, AR",County or equivalent,50955,47616,-3296,7863,5276,2587,94,-6031,-5937,-0.11835933666961045,0.001844764988715533
669,"DeSoto County, MS",County or equivalent,161797,188275,27008,21562,13528,8034,875,18127,19002,0.11203545183161616,0.005408011273385786
670,"Marshall County, MS",County or equivalent,37071,35301,-1858,4387,4320,67,-5,-1915,-1920,-0.051657629953332784,-0.00013487631841601252
671,"Tate County, MS",County or equivalent,28978,28539,-324,3483,2954,529,65,-930,-865,-0.032093312167851475,0.002243080957968114
672,"Tunica County, MS",County or equivalent,10763,9392,-1386,1884,1081,803,73,-2277,-2204,-0.21155811576697947,0.0067824955867323245
673,"Fayette County, TN",County or equivalent,38427,41620,3181,4274,4080,194,152,2834,2986,0.07375022770447863,0.003955552085773024
674,"Shelby County, TN",County or equivalent,928475,936017,8335,137903,83001,54902,13107,-59777,-46670,-0.06438191658364523,0.014116696733891597
675,"Tipton County, TN",County or equivalent,61067,61918,910,7390,5948,1442,206,-731,-525,-0.011970458676535609,0.003373344031964891
676,"Merced County, CA",County or equivalent,256709,279252,23455,42237,17487,24750,-207,-1044,-1251,-0.00406686169943399,-0.0008063605093705324
677,"Broward County, FL",County or equivalent,1752843,1958105,209947,223220,154173,69047,154945,-12743,142202,-0.007269903807699834,0.08839639374433421
678,"Miami-Dade County, FL",County or equivalent,2506986,2707303,209300,321239,201879,119360,411973,-322450,89523,-0.12862058264386,0.16432999625845535
679,"Palm Beach County, FL",County or equivalent,1323631,1507600,187476,148812,147119,1693,88703,96967,185670,0.07325833257153995,0.06701490067851236
680,"LaPorte County, IN",County or equivalent,111458,109663,-1803,13352,12298,1054,295,-3092,-2797,-0.02774139137612374,0.00264673688743742
681,"Midland County, MI",County or equivalent,83660,83441,-182,8810,7532,1278,1340,-2795,-1455,-0.03340903657661965,0.016017212526894573
682,"Martin County, TX",County or equivalent,4809,5816,1017,927,454,473,63,468,531,0.09731752963194013,0.013100436681222708
683,"Midland County, TX",County or equivalent,136987,177863,40976,28321,11059,17262,3657,19559,23216,0.14277997182214372,0.026695963850584363
684,"Milwaukee County, WI",County or equivalent,948289,945016,-2696,140467,85158,55309,22835,-80695,-57860,-0.08509536649692236,0.024080211834156044
685,"Ozaukee County, WI",County or equivalent,86378,90043,3648,8408,7828,580,948,2179,3127,0.02522633077867049,0.010975016786681792
686,"Washington County, WI",County or equivalent,131990,136445,4560,13648,11475,2173,692,1796,2488,0.013607091446321691,0.005242821425865596
687,"Waukesha County, WI",County or equivalent,390051,406172,16210,39288,34395,4893,4592,7048,11640,0.018069431946078848,0.011772819451815277
688,"Anoka County, MN",County or equivalent,331441,359921,29063,43006,20947,22059,4577,2693,7270,0.008125126342244925,0.01380939594075567
689,"Carver County, MN",County or equivalent,91332,106565,15551,11860,5087,6773,687,8131,8818,0.08902684710725704,0.007522007620549205
690,"Chisago County, MN",County or equivalent,53905,56794,2902,5836,4173,1663,211,1040,1251,0.01929320100176236,0.0039142936647806326
691,"Dakota County, MN",County or equivalent,399214,431807,33225,53431,25440,27991,6511,-1115,5396,-0.002792988221855947,0.01630954826233549
692,"Hennepin County, MN",County or equivalent,1154323,1268408,115921,166544,86869,79675,49624,-12688,36936,-0.010991724153464845,0.04298970045645803
693,"Isanti County, MN",County or equivalent,37856,41429,3618,4659,3236,1423,165,2042,2207,0.05394125105663567,0.004358622147083686
694,"Le Sueur County, MN",County or equivalent,27732,28741,1040,3264,2307,957,161,-73,88,-0.0026323380931775565,0.0058055675753642
695,"Mille Lacs County, MN",County or equivalent,26073,26146,52,3258,3026,232,67,-242,-175,-0.00928163233996855,0.002569708127181375
696,"Ramsey County, MN",County or equivalent,509364,547903,39292,78250,42615,35635,27188,-23153,4035,-0.045454723930234565,0.05337636739149214
697,"Scott County, MN",County or equivalent,130514,150689,20773,18956,6611,12345,2053,6431,8484,0.04927440734327352,0.01573011324455614
698,"Sherburne County, MN",County or equivalent,88800,98811,10319,12225,5267,6958,510,2879,3389,0.032421171171171166,0.0057432432432432436
699,"Washington County, MN",County or equivalent,238933,265476,27367,28789,15943,12846,2813,11922,14735,0.049896833003394266,0.011773174906773027
700,"Wright County, MN",County or equivalent,125093,140249,15554,18323,7992,10331,701,4617,5318,0.036908540046205626,0.005603830749922058
701,"Pierce County, WI",County or equivalent,41091,42700,1671,3950,2800,1150,345,173,518,0.004210167676620184,0.008395999123895744
702,"St. Croix County, WI",County or equivalent,84399,91838,7506,10634,6041,4593,205,2738,2943,0.032441142667567154,0.002428938731501558
703,"Missoula County, MT",County or equivalent,109471,121630,12335,12092,8909,3183,1944,7220,9164,0.06595354020699545,0.017758127723323986
704,"Mobile County, AL",County or equivalent,413328,412716,-423,56987,44731,12256,5079,-17548,-12469,-0.042455386521116405,0.01228806178144234
705,"Washington County, AL",County or equivalent,17627,15976,-1604,1755,2096,-341,119,-1385,-1266,-0.0785726442389516,0.0067510069779315824
706,"Stanislaus County, CA",County or equivalent,515137,550081,35630,77693,42529,35164,4094,-3365,729,-0.0065322428790787705,0.007947400400281867
707,"Morehouse Parish, LA",County or equivalent,27873,24227,-3752,3577,3841,-264,24,-3524,-3500,-0.12643059591719585,0.0008610483263373157
708,"Ouachita Parish, LA",County or equivalent,153966,152439,-1293,22542,16032,6510,897,-8604,-7707,-0.055882467557772486,0.005825961575932349
709,"Union Parish, LA",County or equivalent,22842,22170,-611,2744,2713,31,111,-751,-640,-0.0328780316959986,0.00485946939847649
710,"Monroe County, MI",County or equivalent,151936,150568,-1463,15571,14929,642,363,-2460,-2097,-0.01619102780117944,0.002389163858466723
711,"Autauga County, AL",County or equivalent,54761,56145,1563,6455,5790,665,89,803,892,0.01466372053103486,0.001625244243165757
712,"Elmore County, AL",County or equivalent,79558,82158,2879,9620,7918,1702,436,773,1209,0.009716181905025264,0.005480278538927575
713,"Lowndes County, AL",County or equivalent,11294,9641,-1661,1311,1402,-91,0,-1589,-1589,-0.14069417389764474,0.0
714,"Montgomery County, AL",County or equivalent,229498,224639,-4726,32118,21750,10368,4361,-19523,-15162,-0.08506827946213039,0.019002344247008692
715,"Monongalia County, WV",County or equivalent,96768,106819,10627,10908,7135,3773,4356,2396,6752,0.024760251322751326,0.04501488095238095
716,"Preston County, WV",County or equivalent,33546,33380,-131,3460,3759,-299,256,-84,172,-0.002504024324807727,0.007631312227985453
717,"Grainger County, TN",County or equivalent,22718,23565,911,2338,2913,-575,53,1441,1494,0.06342987939079145,0.002332951844352496
718,"Hamblen County, TN",County or equivalent,62509,65110,2576,7952,7756,196,704,1726,2430,0.02761202386856293,0.011262378217536673
719,"Jefferson County, TN",County or equivalent,51719,55307,3634,5221,6288,-1067,115,4592,4707,0.08878748622363154,0.002223554206384501
720,"Skagit County, WA",County or equivalent,116939,130789,13897,14792,12202,2590,2040,9304,11344,0.07956284900674711,0.017444992688495708
721,"Delaware County, IN",County or equivalent,117671,113454,-4220,12104,12799,-695,1433,-4951,-3518,-0.04207493775016784,0.012178021772569282
722,"Muskegon County, MI",County or equivalent,171923,173883,1681,21441,17713,3728,846,-2888,-2042,-0.016798217806808863,0.004920807570831128
723,"Brunswick County, NC",County or equivalent,108070,149039,41610,10531,13962,-3431,76,44509,44585,0.4118534283334875,0.0007032478948829463
724,"Horry County, SC",County or equivalent,270295,365449,96313,31902,34200,-2298,3585,94002,97587,0.3477755785345641,0.01326328640929355
725,"Napa County, CA",County or equivalent,136752,135965,-570,14281,12639,1642,1066,-3169,-2103,-0.023173335673335668,0.007795132795132795
726,"Collier County, FL",County or equivalent,322576,392973,71459,32959,33701,-742,22644,49432,72076,0.15324140667625613,0.07019741084271612
727,"Cannon County, TN",County or equivalent,13796,14847,1034,1617,1783,-166,73,1126,1199,0.08161786024934764,0.005291388808350246
728,"Cheatham County, TN",County or equivalent,39120,41101,2000,4628,4076,552,162,1303,1465,0.033307770961145185,0.004141104294478528
729,"Davidson County, TN",County or equivalent,627794,694176,67599,102198,54407,47791,27280,-7856,19424,-0.012513658939078742,0.04345374438111865
730,"Dickson County, TN",County or equivalent,49692,54376,4718,6322,5614,708,-8,4021,4013,0.08091845769942847,-0.00016099170892699022
731,"Macon County, TN",County or equivalent,22236,24827,2602,3321,2782,539,240,1825,2065,0.08207411404928944,0.01079330814894765
732,"Maury County, TN",County or equivalent,81230,99590,18604,11814,9133,2681,552,15279,15831,0.18809553120768188,0.006795518896959251
733,"Robertson County, TN",County or equivalent,66314,72275,5963,9078,6783,2295,498,3183,3681,0.04799891425641644,0.007509726452936031
734,"Rutherford County, TN",County or equivalent,263721,339261,76668,40482,19148,21334,4611,50254,54865,0.1905574451788064,0.01748438690889235
735,"Smith County, TN",County or equivalent,19127,20285,1135,2310,2239,71,-7,1073,1066,0.056098708631777065,-0.0003659748000209128
736,"Sumner County, TN",County or equivalent,161226,195561,34922,21109,15524,5585,1201,28013,29214,0.17374989145671293,0.007449170729286841
737,"Trousdale County, TN",County or equivalent,7868,11455,3597,1053,949,104,-1,3458,3457,0.4395017793594306,-0.00012709710218607016
738,"Williamson County, TN",County or equivalent,184082,245348,62140,22368,12055,10313,4296,47333,51629,0.25712997468519466,0.023337425712454236
739,"Wilson County, TN",County or equivalent,114681,148130,34067,15222,10826,4396,1166,28281,29447,0.24660580218170405,0.010167333734445986
740,"Craven County, NC",County or equivalent,104180,101233,-2265,15153,10869,4284,2501,-9083,-6582,-0.08718564023804952,0.02400652716452294
741,"Jones County, NC",County or equivalent,10139,9250,-913,974,1310,-336,39,-616,-577,-0.06075549856987869,0.003846533188677385
742,"Pamlico County, NC",County or equivalent,13108,12715,-428,888,1683,-795,19,351,370,0.02677754043332316,0.001449496490692707
743,"New Haven County, CT",County or equivalent,863398,851948,-10528,90367,79982,10385,34281,-55277,-20996,-0.06402261761088165,0.03970474798412783
744,"Jefferson Parish, LA",County or equivalent,432618,432346,-230,58872,43035,15837,15092,-30992,-15900,-0.07163825823243601,0.03488527985428253
745,"Orleans Parish, LA",County or equivalent,347789,389476,45648,48524,33412,15112,7048,22543,29591,0.06481803622311229,0.0202651607727674
746,"Plaquemines Parish, LA",County or equivalent,23120,23113,76,2964,1861,1103,223,-1265,-1042,-0.05471453287197232,0.009645328719723184
747,"St. Bernard Parish, LA",County or equivalent,36821,47647,11750,6388,3610,2778,538,8235,8773,0.2236495478123897,0.014611227288775425
748,"St. Charles Parish, LA",County or equivalent,52817,52987,99,6411,4360,2051,412,-2385,-1973,-0.045155915708957335,0.0078005187723649595
749,"St. James Parish, LA",County or equivalent,22051,20727,-1378,2692,2101,591,27,-1998,-1971,-0.09060813568545643,0.0012244342660196815
750,"St. John the Baptist Parish, LA",County or equivalent,45588,42516,-3294,5733,4227,1506,501,-5377,-4876,-0.11794770553654473,0.010989734140563309
751,"St. Tammany Parish, LA",County or equivalent,234564,263446,29686,29404,22486,6918,2127,20691,22818,0.08821046707934721,0.00906788765539469
752,"Nassau County, NY",County or equivalent,1341642,1351334,11480,145334,113411,31923,26283,-46054,-19771,-0.03432659383054496,0.01959017383176734
753,"Suffolk County, NY",County or equivalent,1494337,1474273,-18843,160899,124888,36011,27166,-82116,-54950,-0.0549514600789514,0.01817929958235659
754,"Essex County, NJ",County or equivalent,784017,800501,16646,106241,61264,44977,42296,-70995,-28699,-0.09055288341961973,0.05394780980514453
755,"Hunterdon County, NJ",County or equivalent,127323,124797,-2567,9583,9221,362,1151,-4099,-2948,-0.03219371205516678,0.00904000062832324
756,"Morris County, NJ",County or equivalent,492623,491087,-1194,47629,39193,8436,11434,-21015,-9581,-0.0426593967394945,0.0232104469340652
757,"Sussex County, NJ",County or equivalent,148859,140002,-8939,12655,12337,318,381,-9759,-9378,-0.06555868304905985,0.0025594690277376576
758,"Union County, NJ",County or equivalent,537336,555394,18968,69722,40932,28790,26588,-36287,-9699,-0.06753130257418077,0.049481144014173625
759,"Pike County, PA",County or equivalent,57382,56072,-1287,3715,4798,-1083,402,-610,-208,-0.010630511310166952,0.0070056812240772365
760,"Middlesex County, NJ",County or equivalent,810813,822736,12637,96611,60728,35883,47882,-71502,-23620,-0.08818556189898287,0.059054307220037176
761,"Monmouth County, NJ",County or equivalent,630454,618381,-11966,60904,56505,4399,5014,-21364,-16350,-0.0338866911781034,0.007952998949963043
762,"Ocean County, NJ",County or equivalent,577574,614237,37683,86895,74398,12497,2231,23573,25804,0.04081381779650746,0.0038627085014214632
763,"Somerset County, NJ",County or equivalent,324120,329331,5855,34160,24386,9774,9524,-13387,-3863,-0.04130260397383685,0.029384178699247195
764,"Bergen County, NJ",County or equivalent,906293,930394,25287,94809,73868,20941,31900,-26963,4937,-0.02975086423485562,0.035198329899933024
765,"Hudson County, NJ",County or equivalent,635648,671666,37385,105124,39404,65720,70400,-98908,-28508,-0.15560184252919854,0.11075312122432543
766,"Passaic County, NJ",County or equivalent,502010,500382,-1213,70094,38086,32008,25429,-58990,-33561,-0.11750761937013207,0.05065436943487182
767,"Bronx County, NY",County or equivalent,1386929,1401142,16918,214582,99466,115116,121223,-220168,-98945,-0.15874496819952572,0.0874038973876817
768,"Kings County, NY",County or equivalent,2509954,2538934,34078,416347,167730,248617,133341,-347005,-213664,-0.13825153767758294,0.05312487798581169
769,"New York County, NY",County or equivalent,1589041,1611989,25380,185498,106877,78621,103987,-156539,-52552,-0.09851161801363212,0.06544009877655768
770,"Putnam County, NY",County or equivalent,99644,98532,-1101,8574,7271,1303,1194,-3595,-2401,-0.0360784392437076,0.011982658263417769
771,"Queens County, NY",County or equivalent,2234574,2225821,-4690,303380,151261,152119,153353,-310320,-156967,-0.13887210716673515,0.06862739833185208
772,"Richmond County, NY",County or equivalent,469607,475327,6597,54884,37825,17059,6861,-17210,-10349,-0.036647664962404736,0.014610088861537413
773,"Rockland County, NY",County or equivalent,312497,326225,14534,52484,22260,30224,8034,-23802,-15768,-0.07616713120445956,0.025709046806849347
774,"Westchester County, NY",County or equivalent,950760,965802,16426,107463,73684,33779,30358,-47401,-17043,-0.0498559047498843,0.031930245277462244
775,"Berrien County, MI",County or equivalent,156740,153025,-3785,18137,17778,359,3440,-7561,-4121,-0.048239122113053465,0.0219471736633916
776,"Manatee County, FL",County or equivalent,323442,411219,88340,35262,39943,-4681,9946,82295,92241,0.25443510737628383,0.03075049004149121
777,"Sarasota County, FL",County or equivalent,379942,443465,64038,29564,56762,-27198,8851,82044,90895,0.21593822214969652,0.023295660916666232
778,"New London County, CT",County or equivalent,274019,264999,-9077,27091,25087,2004,7141,-18281,-11140,-0.06671435192450159,0.02606023669891504
779,"Marion County, FL",County or equivalent,331341,373513,42217,35199,50252,-15053,5241,52052,57293,0.1570949565553312,0.015817541445218068
780,"Cape May County, NJ",County or equivalent,97222,91546,-5715,8901,13502,-4601,1114,-2131,-1017,-0.02191890724321656,0.011458311904712923
781,"Ector County, TX",County or equivalent,137060,167701,30570,29210,12230,16980,2307,10857,13164,0.07921348314606741,0.016832044360134246
782,"Box Elder County, UT",County or equivalent,50178,57007,7024,8758,3836,4922,205,1908,2113,0.03802463230898003,0.004085455777432341
783,"Davis County, UT",County or equivalent,307919,359232,52740,57688,17311,40377,2471,9983,12454,0.03242086392850068,0.008024837700823918
784,"Morgan County, UT",County or equivalent,9523,12462,2993,1583,588,995,84,1913,1997,0.200882074976373,0.008820749763729917
785,"Weber County, UT",County or equivalent,232136,262658,31440,39459,17464,21995,1726,7832,9558,0.033738842747354995,0.0074352965502981015
786,"Canadian County, OK",County or equivalent,116360,153192,37626,17809,10007,7802,937,28636,29573,0.24609831557236164,0.00805259539360605
787,"Cleveland County, OK",County or equivalent,257094,287066,31075,30164,20133,10031,5197,15747,20944,0.061249970827790615,0.020214396290850815
788,"Grady County, OK",County or equivalent,52434,55906,3483,6085,5644,441,364,2710,3074,0.05168402181790442,0.0069420604950986
789,"Lincoln County, OK",County or equivalent,34355,35045,771,3950,3946,4,35,751,786,0.021859991267646633,0.001018774559743851
790,"Logan County, OK",County or equivalent,42045,48777,6934,5128,3783,1345,97,5465,5562,0.12997978356522774,0.0023070519681293853
791,"McClain County, OK",County or equivalent,34737,41348,6841,4342,3676,666,117,6024,6141,0.173417393557302,0.003368166508334053
792,"Oklahoma County, OK",County or equivalent,720779,804041,85656,122019,72066,49953,19004,16595,35599,0.023023700745998427,0.02636591798595686
793,"Thurston County, WA",County or equivalent,253011,294074,41814,31868,22366,9502,4822,27548,32370,0.10888064155313404,0.019058459908857718
794,"Harrison County, IA",County or equivalent,14908,13928,-1009,1616,1885,-269,3,-751,-748,-0.0503756372417494,0.0002012342366514623
795,"Mills County, IA",County or equivalent,15076,14766,-293,1512,1401,111,20,-422,-402,-0.027991509684266384,0.0013266118333775535
796,"Pottawattamie County, IA",County or equivalent,93363,93328,179,11965,9439,2526,569,-2884,-2315,-0.03089018133521845,0.0060944913938069676
797,"Cass County, NE",County or equivalent,25239,26232,991,2824,2428,396,63,545,608,0.02159356551368913,0.002496136930940212
798,"Douglas County, NE",County or equivalent,518599,574332,57212,86359,41130,45229,14604,-2241,12363,-0.004321257850477922,0.028160486233101106
799,"Sarpy County, NE",County or equivalent,159732,188856,30019,26027,9689,16338,2409,11302,13711,0.0707560163273483,0.01508151153181579
800,"Saunders County, NE",County or equivalent,20867,21927,1149,2517,2109,408,68,683,751,0.03273110653184454,0.003258733886040159
801,"Washington County, NE",County or equivalent,19921,20901,669,2157,1820,337,93,202,295,0.010140053210180213,0.0046684403393403955
802,"Lake County, FL",County or equivalent,297724,375492,78445,32814,40880,-8066,7556,78461,86017,0.2635360266555602,0.025379210275288524
803,"Orange County, FL",County or equivalent,1148590,1404396,258447,166552,79895,86657,126777,44362,171139,0.038623007339433565,0.11037620038481964
804,"Osceola County, FL",County or equivalent,269841,385315,116630,42546,21853,20693,46165,49433,95598,0.18319306554600676,0.17108222990575933
805,"Seminole County, FL",County or equivalent,423072,474171,51451,46852,34082,12770,16631,22254,38885,0.05260097572044475,0.039310093790182285
806,"Winnebago County, WI",County or equivalent,167144,171631,4559,19020,15218,3802,1368,-493,875,-0.0029495524816924327,0.00818455942181592
807,"Daviess County, KY",County or equivalent,96722,101978,5319,13629,10697,2932,1201,1270,2471,0.013130415003825396,0.012417030251649057
808,"Hancock County, KY",County or equivalent,8550,8742,177,1123,871,252,-2,-67,-69,-0.00783625730994152,-0.0002339181286549708
809,"McLean County, KY",County or equivalent,9503,9075,-452,1102,1243,-141,17,-324,-307,-0.03409449647479743,0.0017889087656529515
810,"Ventura County, CA",County or equivalent,825144,841387,17941,101757,57839,43918,5266,-30829,-25563,-0.0373619634875852,0.0063819163685368855
811,"Brevard County, FL",County or equivalent,544000,608459,65083,53029,71908,-18879,10321,73661,83982,0.13540625,0.01897242647058824
812,"Bay County, FL",County or equivalent,169209,171322,2479,22772,19089,3683,4163,-5432,-1269,-0.032102311342777266,0.02460271025772861
813,"Wirt County, WV",County or equivalent,5721,5705,-5,581,634,-53,8,46,54,0.008040552350987589,0.0013983569306065373
814,"Wood County, WV",County or equivalent,86976,82938,-4016,9752,11053,-1301,7,-2643,-2636,-0.030387693156732887,8.048197203826343e-05
815,"Escambia County, FL",County or equivalent,298069,322364,24732,39699,34266,5433,6519,12848,19367,0.04310411347708081,0.02187077488769379
816,"Santa Rosa County, FL",County or equivalent,152924,189139,37768,19341,14692,4649,1085,31820,32905,0.20807721482566505,0.007095027595406869
817,"Fulton County, IL",County or equivalent,37076,33690,-3380,3465,4706,-1241,58,-2180,-2122,-0.05879814435214155,0.0015643542992771606
818,"Marshall County, IL",County or equivalent,12637,11309,-1338,1239,1636,-397,12,-953,-941,-0.07541346838648412,0.000949592466566432
819,"Peoria County, IL",County or equivalent,186224,177652,-8844,26544,18706,7838,3454,-20165,-16711,-0.10828357247186184,0.018547555631927143
820,"Stark County, IL",County or equivalent,5970,5262,-730,621,805,-184,9,-560,-551,-0.09380234505862646,0.001507537688442211
821,"Tazewell County, IL",County or equivalent,135487,130777,-4615,15598,14532,1066,553,-6193,-5640,-0.04570918243078672,0.004081572401780246
822,"Woodford County, IL",County or equivalent,38662,38091,-565,4419,3908,511,87,-1152,-1065,-0.029796699601676063,0.002250271584501577
823,"Burlington County, NJ",County or equivalent,449125,446596,-2134,46182,41274,4908,5124,-11998,-6874,-0.026714166434734204,0.01140885054272196
824,"Camden County, NJ",County or equivalent,513283,506809,-6732,63974,48782,15192,11002,-33118,-22116,-0.06452191091464163,0.021434569233736555
825,"Gloucester County, NJ",County or equivalent,289158,293245,4482,30216,26795,3421,2046,-815,1231,-0.002818528278657343,0.007075716390347145
826,"Bucks County, PA",County or equivalent,625572,627987,2561,59206,60501,-1295,7428,-3240,4188,-0.005179259941301721,0.01187393297653987
827,"Chester County, PA",County or equivalent,499935,526759,27618,56172,40259,15913,10998,1113,12111,0.0022262894176242913,0.02199885985178073
828,"Montgomery County, PA",County or equivalent,800881,833869,34030,90580,77457,13123,20052,1572,21624,0.001962838424185366,0.025037427532929358
829,"Delaware County, PA",County or equivalent,559009,566753,7977,68104,56471,11633,15476,-18945,-3469,-0.033890330924904614,0.02768470632852065
830,"Philadelphia County, PA",County or equivalent,1528303,1578487,52488,226050,148720,77330,82323,-106145,-23822,-0.06945285064545446,0.05386562743120965
831,"New Castle County, DE",County or equivalent,538792,561531,23035,66276,47310,18966,12228,-7754,4474,-0.014391453473696712,0.022695214479799254
832,"Cecil County, MD",County or equivalent,101161,103419,2328,11545,9619,1926,669,-189,480,-0.0018683089332845661,0.006613220509880289
833,"Salem County, NJ",County or equivalent,65983,62451,-3621,6910,7568,-658,520,-3513,-2993,-0.053240986314656805,0.007880817786399527
834,"Maricopa County, AZ",County or equivalent,3825183,4579081,761710,550333,303538,246795,108660,404936,513596,0.10586055621391184,0.02840648408193804
835,"Pinal County, AZ",County or equivalent,379106,480828,105062,46946,29809,17137,8991,78472,87463,0.20699223963746288,0.023716322084060926
836,"Cleveland County, AR",County or equivalent,8677,7957,-735,834,1030,-196,4,-545,-541,-0.06280972686412355,0.0004609888210210903
837,"Jefferson County, AR",County or equivalent,77332,65377,-12052,9191,8653,538,323,-13029,-12706,-0.16848135312677806,0.004176796151657787
838,"Lincoln County, AR",County or equivalent,14090,12944,-1197,1219,1397,-178,57,-1090,-1033,-0.0773598296664301,0.00404542228530873
839,"Allegheny County, PA",County or equivalent,1223973,1211358,-11930,133838,141715,-7877,28719,-31917,-3198,-0.02607655561029533,0.023463752876901698
840,"Armstrong County, PA",County or equivalent,69029,64162,-4946,6485,8759,-2274,28,-2662,-2634,-0.038563502296136414,0.00040562662069564963
841,"Beaver County, PA",County or equivalent,170630,162575,-7957,16894,21899,-5005,338,-3126,-2788,-0.018320342261032643,0.001980894332766805
842,"Butler County, PA",County or equivalent,184085,189135,5284,18482,20019,-1537,1052,5937,6989,0.032251405600673605,0.0057147513376972605
843,"Fayette County, PA",County or equivalent,136431,128126,-8463,13804,18594,-4790,510,-4076,-3566,-0.029875907968130413,0.0037381533522439924
844,"Washington County, PA",County or equivalent,207944,206803,-1049,20451,26109,-5658,896,3932,4828,0.01890893702150579,0.004308852383333974
845,"Westmoreland County, PA",County or equivalent,365029,347087,-17984,31400,46261,-14861,865,-3693,-2828,-0.010117004402389948,0.002369674738171488
846,"Berkshire County, MA",County or equivalent,131318,124571,-6703,10857,15234,-4377,2803,-5059,-2256,-0.038524802388096066,0.021345131665118262
847,"Bannock County, ID",County or equivalent,83026,88795,5953,12731,7199,5532,1919,-1497,422,-0.018030496470984998,0.02311324163515044
848,"Power County, ID",County or equivalent,7873,7643,-176,1283,626,657,34,-880,-846,-0.1117744189000381,0.004318557093865108
849,"Cumberland County, ME",County or equivalent,281481,298111,16424,28407,27029,1378,7634,7582,15216,0.02693609870648463,0.02712083586458766
850,"Sagadahoc County, ME",County or equivalent,35229,36044,757,3359,3704,-345,75,1044,1119,0.029634675977177893,0.0021289278719236987
851,"York County, ME",County or equivalent,197215,209066,11937,19019,20066,-1047,1169,11967,13136,0.060679968562229035,0.005927541008543975
852,"Clackamas County, OR",County or equivalent,376799,421596,45605,41061,34188,6873,2805,35913,38718,0.09531076250202362,0.00744428727252461
853,"Columbia County, OR",County or equivalent,49353,52876,3526,5058,4565,493,92,2939,3031,0.05955058456426154,0.0018641217352541887
854,"Multnomah County, OR",County or equivalent,737320,815637,80485,92054,58676,33378,25876,20659,46535,0.028019041935658868,0.03509466717300494
855,"Washington County, OR",County or equivalent,531652,603514,73649,70825,33819,37006,19124,17589,36713,0.033083671273690315,0.03597089825675442
856,"Yamhill County, OR",County or equivalent,99298,107664,8450,11399,9300,2099,158,6219,6377,0.06262966021470724,0.001591170013494733
857,"Clark County, WA",County or equivalent,426733,496865,71505,56541,34842,21699,3738,46045,49783,0.10790119348632517,0.008759575659721653
858,"Skamania County, WA",County or equivalent,11115,12107,1037,981,880,101,80,855,935,0.07692307692307693,0.007197480881691407
859,"Martin County, FL",County or equivalent,146912,162088,15237,12552,19451,-6899,1499,20553,22052,0.13990007623611414,0.010203387061642344
860,"St. Lucie County, FL",County or equivalent,278290,337186,59929,31170,32154,-984,7775,53011,60786,0.1904883395019584,0.027938481440224226
861,"Dutchess County, NY",County or equivalent,297721,293293,-4151,26993,25568,1425,4237,-9831,-5594,-0.03302084837817957,0.014231444876243194
862,"Orange County, NY",County or equivalent,373451,385234,12411,50596,27744,22852,3734,-14256,-10522,-0.038173682758916166,0.009998634358992209
863,"Yavapai County, AZ",County or equivalent,210990,240226,29218,18829,29931,-11102,836,39261,40097,0.18607990900042656,0.003962273093511541
864,"Bristol County, MA",County or equivalent,549175,566765,18526,57911,54466,3445,13780,1778,15558,0.0032375836481995717,0.025092183730140667
865,"Bristol County, RI",County or equivalent,49817,48350,-1492,3455,5264,-1809,463,-118,345,-0.002368669329746873,0.009294016098922057
866,"Kent County, RI",County or equivalent,166029,164646,-1463,16075,17926,-1851,1178,-677,501,-0.0040776009010474075,0.0070951460287058295
867,"Newport County, RI",County or equivalent,83186,81836,-1305,7094,7534,-440,2063,-2874,-811,-0.034549082778352135,0.024799846127954224
868,"Providence County, RI",County or equivalent,627868,636547,9751,74744,58650,16094,31842,-38168,-6326,-0.0607898475475737,0.050714481387807625
869,"Washington County, RI",County or equivalent,127094,125746,-1336,9175,11807,-2632,1092,309,1401,0.002431271342470927,0.008592065715139973
870,"Juab County, UT",County or equivalent,10263,12122,1876,1911,761,1150,70,655,725,0.06382149468966189,0.006820617753093637
871,"Utah County, UT",County or equivalent,520033,651059,134420,121760,24189,97571,8343,28636,36979,0.05506573621289418,0.016043212642274624
872,"Pueblo County, CO",County or equivalent,159401,169823,10757,19008,17833,1175,443,9240,9683,0.05796701400869505,0.0027791544595077823
873,"Charlotte County, FL",County or equivalent,159897,194711,34737,10452,26195,-15743,3075,47058,50133,0.2943019568847445,0.019231130039963226
874,"Racine County, WI",County or equivalent,195407,195802,368,24302,18401,5901,1189,-6670,-5481,-0.034133884661245506,0.006084735961352459
875,"Franklin County, NC",County or equivalent,60835,71859,11295,7139,5935,1204,609,9469,10078,0.1556505301224624,0.01001068463877702
876,"Johnston County, NC",County or equivalent,169676,216246,47367,23594,14447,9147,1349,36712,38061,0.21636530799877413,0.007950446733774959
877,"Wake County, NC",County or equivalent,906875,1132271,231235,129514,54593,74921,36617,118402,155019,0.1305604410751206,0.04037711922811854
878,"Meade County, SD",County or equivalent,25478,28588,3155,2994,2003,991,456,1696,2152,0.06656723447680353,0.017897794175366983
879,"Pennington County, SD",County or equivalent,101253,115926,14960,15630,9068,6562,1272,7089,8361,0.07001274036324849,0.012562590738052206
880,"Berks County, PA",County or equivalent,412041,421017,9448,48972,39880,9092,14196,-13727,469,-0.033314645872619474,0.0344528821161001
881,"Shasta County, CA",County or equivalent,177277,179027,1805,20960,22660,-1700,2008,1689,3697,0.009527462671412535,0.011326906479689976
882,"Storey County, NV",County or equivalent,3997,4207,194,182,316,-134,-8,332,324,0.08306229672254191,-0.0020015011258443832
883,"Washoe County, NV",County or equivalent,421969,477082,55653,55040,39171,15869,1035,38649,39684,0.09159203638181952,0.002452786816093125
884,"Amelia County, VA",County or equivalent,12741,13014,324,1401,1503,-102,28,403,431,0.031630170316301706,0.002197629699395652
885,"Charles City County, VA",County or equivalent,7255,6821,-431,593,864,-271,3,-161,-158,-0.02219159200551344,0.0004135079255685734
886,"Chesterfield County, VA",County or equivalent,317210,358245,42009,39709,24472,15237,5923,21140,27063,0.06664354843794333,0.018672173008417132
887,"Dinwiddie County, VA",County or equivalent,28062,28688,677,3075,2708,367,158,168,326,0.005986743639084883,0.0056303898510441175
888,"Goochland County, VA",County or equivalent,21906,24431,2579,1766,1979,-213,20,2756,2776,0.12581028028850544,0.000912991874372318
889,"Hanover County, VA",County or equivalent,99886,108262,8429,9497,9329,168,784,7556,8340,0.07564623670984923,0.007848947800492561
890,"Henrico County, VA",County or equivalent,307201,333766,27068,41311,28018,13293,16123,-2155,13968,-0.007014951123205979,0.05248355311343388
891,"King and Queen County, VA",County or equivalent,6976,6942,2,651,844,-193,28,171,199,0.02451261467889908,0.004013761467889909
892,"King William County, VA",County or equivalent,15999,17641,1714,2025,1498,527,70,1123,1193,0.07019188699293706,0.004375273454590912
893,"New Kent County, VA",County or equivalent,18543,23648,5216,2025,1650,375,96,4702,4798,0.25357277678908485,0.005177155800032357
894,"Powhatan County, VA",County or equivalent,28133,30148,2075,2492,2149,343,64,1673,1737,0.059467529236128386,0.0022749084704795077
895,"Prince George County, VA",County or equivalent,35643,38686,2971,4136,2461,1675,1120,148,1268,0.0041522879667816965,0.03142271974861824
896,"Sussex County, VA",County or equivalent,12013,10925,-1146,987,1411,-424,29,-759,-730,-0.06318155331723965,0.002414051444268709
897,"Colonial Heights city, VA",County or equivalent,17338,17205,-204,2079,2455,-376,323,-142,181,-0.008190102664667204,0.01862959972315146
898,"Hopewell city, VA",County or equivalent,22640,22375,-216,3422,3081,341,524,-1083,-559,-0.0478356890459364,0.02314487632508834
899,"Petersburg city, VA",County or equivalent,32502,30446,-1995,5024,4936,88,504,-2589,-2085,-0.07965663651467601,0.015506738046889422
900,"Richmond city, VA",County or equivalent,204375,232226,27786,30040,19536,10504,7069,9832,16901,0.04810764525993884,0.034588379204892966
901,"Riverside County, CA",County or equivalent,2201562,2489188,299403,306180,165842,140338,9825,149712,159537,0.06800262722557893,0.004462740545122054
902,"San Bernardino County, CA",County or equivalent,2040803,2189183,154011,309920,140804,169116,10018,-24370,-14352,-0.011941377977198192,0.004908852054803918
903,"Botetourt County, VA",County or equivalent,33195,33633,484,2675,3478,-803,98,1220,1318,0.036752522970326856,0.002952251845157403
904,"Craig County, VA",County or equivalent,5198,5077,-98,413,541,-128,-3,34,31,0.006540977298961139,-0.0005771450557906887
905,"Franklin County, VA",County or equivalent,56174,56167,43,5219,6173,-954,-56,1114,1058,0.01983123865133336,-0.000996902481575106
906,"Roanoke County, VA",County or equivalent,92416,94509,2033,8500,10282,-1782,1649,2244,3893,0.02428150969529086,0.01784323060941828
907,"Roanoke city, VA",County or equivalent,96722,99058,2148,14345,12463,1882,4320,-4035,285,-0.041717499638138165,0.04466408883191001
908,"Salem city, VA",County or equivalent,24897,25340,506,2320,3347,-1027,419,1125,1544,0.045186167008073264,0.01682933686789573
909,"Dodge County, MN",County or equivalent,20157,20987,900,2590,1502,1088,130,-314,-184,-0.01557771493773875,0.006449372426452349
910,"Fillmore County, MN",County or equivalent,20864,21135,265,2603,2396,207,199,-131,68,-0.006278757668711657,0.009537960122699387
911,"Olmsted County, MN",County or equivalent,144535,159298,15030,21833,10540,11293,5524,-1717,3807,-0.01187947555955305,0.038219116476977885
912,"Wabasha County, MN",County or equivalent,21672,21642,-23,2401,1942,459,69,-542,-473,-0.02500922849760059,0.0031838316722037647
913,"Livingston County, NY",County or equivalent,65226,62398,-2796,5376,5646,-270,765,-3275,-2510,-0.05021003894152638,0.011728451844356546
914,"Monroe County, NY",County or equivalent,744589,740900,-3496,83630,68299,15331,20691,-39511,-18820,-0.0530641736582195,0.02778848465395003
915,"Ontario County, NY",County or equivalent,108183,110091,1985,10406,11061,-655,1248,1490,2738,0.013772958782803213,0.011536008430160007
916,"Orleans County, NY",County or equivalent,42850,39978,-2913,4095,4367,-272,269,-2922,-2653,-0.06819136522753792,0.0062777129521586926
917,"Wayne County, NY",County or equivalent,93751,89339,-4412,9992,8955,1037,396,-5866,-5470,-0.0625699992533413,0.004223954944480592
918,"Yates County, NY",County or equivalent,25376,24780,-584,3241,2670,571,145,-1299,-1154,-0.05119010088272384,0.0057140605296343
919,"Boone County, IL",County or equivalent,54094,52777,-1384,5828,4152,1676,-145,-2935,-3080,-0.05425740377860761,-0.002680519096387769
920,"Winnebago County, IL",County or equivalent,295090,281295,-13975,36735,29437,7298,3602,-25066,-21464,-0.08494357653597208,0.012206445491206072
921,"Edgecombe County, NC",County or equivalent,56595,50829,-5682,6392,6610,-218,125,-5623,-5498,-0.09935506670200547,0.0022086756780634333
922,"Nash County, NC",County or equivalent,95819,94859,-999,11038,10783,255,504,-1751,-1247,-0.01827403750821862,0.005259917135432429
923,"Floyd County, GA",County or equivalent,96436,98604,2286,12044,11091,953,1410,-20,1390,-0.00020739143058608815,0.01462109585631922
924,"El Dorado County, CA",County or equivalent,181161,192925,11846,16332,15422,910,1233,9821,11054,0.05421144727617975,0.006806100650802325
925,"Placer County, CA",County or equivalent,350007,402950,54469,38055,32025,6030,2888,45624,48512,0.1303516786807121,0.008251263546157649
926,"Sacramento County, CA",County or equivalent,1421381,1559146,140410,199908,116032,83876,39539,17924,57463,0.0126102712784257,0.027817312880923557
927,"Yolo County, CA",County or equivalent,201061,219728,18873,23815,13254,10561,9870,-1539,8331,-0.00765439344278602,0.04908957977927097
928,"Saginaw County, MI",County or equivalent,199871,189868,-10301,22928,21691,1237,1859,-13486,-11627,-0.06747352042067133,0.00930099914444817
929,"Benton County, MN",County or equivalent,38465,40958,2507,5776,3583,2193,595,-272,323,-0.0070713635772780455,0.015468607825295725
930,"Stearns County, MN",County or equivalent,150768,162038,11392,20366,10432,9934,5926,-4441,1485,-0.029455852700838375,0.03930542290141144
931,"Washington County, UT",County or equivalent,138397,184913,46798,22746,12994,9752,269,36636,36905,0.2647167207381663,0.0019436837503703113
932,"Doniphan County, KS",County or equivalent,7959,7496,-452,844,820,24,22,-495,-473,-0.06219374293252921,0.0027641663525568537
933,"Andrew County, MO",County or equivalent,17345,17586,290,1930,1698,232,-16,84,68,0.004842894205823004,-0.0009224560392043816
934,"Buchanan County, MO",County or equivalent,89071,86530,-2661,11755,9810,1945,1767,-6359,-4592,-0.0713924846470793,0.01983810667894152
935,"DeKalb County, MO",County or equivalent,12899,10944,-1944,1074,1233,-159,4,-1790,-1786,-0.1387704473214978,0.00031010155826033023
936,"Bond County, IL",County or equivalent,17789,16262,-1508,1598,1756,-158,98,-1467,-1369,-0.0824666929001068,0.005509022429591321
937,"Calhoun County, IL",County or equivalent,5093,4616,-471,472,546,-74,11,-411,-400,-0.0806989986255645,0.0021598272138228947
938,"Clinton County, IL",County or equivalent,37833,37398,-354,4238,3622,616,47,-1007,-960,-0.026616974598895143,0.0012423016942880553
939,"Jersey County, IL",County or equivalent,22997,21616,-1395,2180,2576,-396,157,-1165,-1008,-0.05065878158020611,0.006826977431838936
940,"Macoupin County, IL",County or equivalent,47798,44567,-3197,4698,5787,-1089,63,-2174,-2111,-0.045483074605632036,0.0013180467802000086
941,"Madison County, IL",County or equivalent,269315,262635,-6661,31044,28998,2046,978,-9626,-8648,-0.03574253197928077,0.0036314353080964673
942,"Monroe County, IL",County or equivalent,33051,34739,1733,3548,3001,547,24,1193,1217,0.03609573084021663,0.0007261504946900245
943,"St. Clair County, IL",County or equivalent,270368,258046,-12029,33796,26398,7398,1901,-21452,-19551,-0.0793437093147118,0.007031157533435911
944,"Franklin County, MO",County or equivalent,101424,104469,3005,12617,10493,2124,160,788,948,0.007769364253036755,0.0015775358889414735
945,"Jefferson County, MO",County or equivalent,219130,226543,7821,26665,20602,6063,670,1259,1929,0.005745447907634736,0.0030575457490987085
946,"Lincoln County, MO",County or equivalent,52673,60119,7583,7696,4757,2939,62,4615,4677,0.0876160461716629,0.0011770736430429252
947,"St. Charles County, MO",County or equivalent,361808,406204,45716,45826,28007,17819,4713,23305,28018,0.06441261663644808,0.013026245964710564
948,"St. Louis County, MO",County or equivalent,998846,994020,-4941,118492,101760,16732,20776,-42232,-21456,-0.04228079203400725,0.020800003203697067
949,"Warren County, MO",County or equivalent,32612,36594,4048,4271,2990,1281,62,2731,2793,0.08374218079234637,0.0019011406844106464
950,"St. Louis city, MO",County or equivalent,319367,297645,-21663,45826,31118,14708,8601,-44865,-36264,-0.1404810140058303,0.026931398673000033
951,"Marion County, OR",County or equivalent,315948,349204,33862,44565,28377,16188,2180,15659,17839,0.049561953232810464,0.006899869598794738
952,"Polk County, OR",County or equivalent,75540,87744,12341,8935,7043,1892,689,9777,10466,0.12942811755361394,0.009120995499073338
953,"Monterey County, CA",County or equivalent,416358,430906,15848,64707,25951,38756,2471,-25268,-22797,-0.06068815778728881,0.005934796497245159
954,"Sussex County, DE",County or equivalent,197883,241635,44536,23179,25445,-2266,2048,44442,46490,0.2245872561058808,0.010349549986608248
955,"Somerset County, MD",County or equivalent,26464,25453,-1017,2549,2792,-243,365,-1159,-794,-0.0437953446191052,0.013792321644498184
956,"Wicomico County, MD",County or equivalent,98974,103990,5256,12754,9920,2834,3346,-866,2480,-0.008749772667569261,0.033806858366843814
957,"Worcester County, MD",County or equivalent,51500,52403,955,4377,6511,-2134,453,2685,3138,0.05213592233009709,0.00879611650485437
958,"Salt Lake County, UT",County or equivalent,1032997,1165517,135927,177462,66162,111300,31201,-5980,25221,-0.005788980994136479,0.030204347156864923
959,"Tooele County, UT",County or equivalent,58502,74512,16294,10089,3653,6436,485,9400,9885,0.1606782674096612,0.008290314861030395
960,"Irion County, TX",County or equivalent,1615,1564,-41,153,139,14,0,-56,-56,-0.0346749226006192,0.0
961,"Sterling County, TX",County or equivalent,1137,1315,172,149,163,-14,10,174,184,0.15303430079155672,0.008795074758135445
962,"Tom Green County, TX",County or equivalent,110675,120010,9790,15914,10665,5249,798,3704,4502,0.03346735938558843,0.007210300429184548
963,"Atascosa County, TX",County or equivalent,44964,51724,6801,6946,4151,2795,24,3966,3990,0.08820389645049373,0.0005337603416066186
964,"Bandera County, TX",County or equivalent,20546,23861,3388,1731,2258,-527,70,3842,3912,0.18699503553003016,0.0034069891949771247
965,"Bexar County, TX",County or equivalent,1722841,2026823,312042,275579,132360,143219,43829,123922,167751,0.07192886633183213,0.02543995644403633
966,"Comal County, TX",County or equivalent,109311,164812,56287,14846,11546,3300,1019,51558,52577,0.4716634190520624,0.009322026145584616
967,"Guadalupe County, TX",County or equivalent,132581,170608,39086,18277,10558,7719,801,30281,31082,0.22839622570353216,0.006041589669711346
968,"Kendall County, TX",County or equivalent,33594,48523,15138,3704,3763,-59,497,14580,15077,0.4340060725129488,0.014794308507471573
969,"Medina County, TX",County or equivalent,46130,52358,6349,5776,4204,1572,100,4689,4789,0.1016475178842402,0.0021677866897897246
970,"Wilson County, TX",County or equivalent,43054,52023,9116,5249,3974,1275,226,7569,7795,0.1758024806057509,0.0052492219073721385
971,"San Diego County, CA",County or equivalent,3103260,3332427,237075,436256,217725,218531,102224,-81175,21049,-0.02615797580608779,0.03294084285557768
972,"Alameda County, CA",County or equivalent,1512997,1662323,152040,195466,100835,94631,97617,-40073,57544,-0.026485842338087914,0.06451896467739196
973,"Contra Costa County, CA",County or equivalent,1052516,1152333,103145,124894,79024,45870,34474,23163,57637,0.022007266397850483,0.03275389637782228
974,"San Francisco County, CA",County or equivalent,805519,866606,61422,90880,59821,31059,55243,-25184,30059,-0.031264315304791075,0.06858062938304373
975,"San Mateo County, CA",County or equivalent,719948,758308,39780,90332,49160,41172,39087,-40108,-1021,-0.05570957902515181,0.05429142104707562
976,"Marin County, CA",County or equivalent,252906,257332,4907,23233,19889,3344,5997,-4283,1714,-0.01693514586447139,0.023712367440867358
977,"San Benito County, CA",County or equivalent,55544,64055,8790,7706,3291,4415,-389,4790,4401,0.08623793749099813,-0.007003456718997552
978,"Santa Clara County, CA",County or equivalent,1786001,1907105,125425,234493,102786,131707,154765,-159849,-5084,-0.08950106970824764,0.08665448675560652
979,"San Luis Obispo County, CA",County or equivalent,269800,282249,12650,26424,24329,2095,733,9870,10603,0.036582653817642696,0.0027168272794662715
980,"Santa Cruz County, CA",County or equivalent,263174,269925,7580,29038,18157,10881,1603,-4810,-3207,-0.01827688145485496,0.006091027229133577
981,"Santa Fe County, NM",County or equivalent,144526,151946,7709,13243,11800,1443,2680,3727,6407,0.025787747533315804,0.018543376278316703
982,"Santa Barbara County, CA",County or equivalent,424218,444766,20819,57494,31893,25601,8432,-12997,-4565,-0.03063754956178192,0.01987657289412519
983,"Sonoma County, CA",County or equivalent,484675,489819,5953,50154,42154,8000,2871,-4655,-1784,-0.00960437406509517,0.005923557022747202
984,"Bryan County, GA",County or equivalent,30404,40755,10517,5240,2560,2680,382,7436,7818,0.24457308248914614,0.012564136297855546
985,"Chatham County, GA",County or equivalent,265799,289463,24351,39133,24516,14617,6697,2954,9651,0.011113661074721877,0.0251957306084673
986,"Effingham County, GA",County or equivalent,52469,65765,13507,7731,4367,3364,373,9743,10116,0.18569059825801898,0.007108959576130667
987,"Lackawanna County, PA",County or equivalent,214523,208989,-5438,22025,27580,-5555,6580,-6347,233,-0.02958657113689441,0.030672701761582682
988,"Luzerne County, PA",County or equivalent,321017,316982,-3935,32908,41492,-8584,8819,-3899,4920,-0.012145774211334602,0.02747206534233389
989,"Wyoming County, PA",County or equivalent,28250,26557,-1734,2794,3220,-426,76,-1375,-1299,-0.04867256637168142,0.0026902654867256635
990,"King County, WA",County or equivalent,1938431,2274315,343026,256380,132315,124065,171295,47335,218630,0.024419233906184952,0.08836786039843564
991,"Snohomish County, WA",County or equivalent,715522,830393,117094,98063,53988,44075,25822,47011,72833,0.06570168352615294,0.036088338304063335
992,"Pierce County, WA",County or equivalent,795402,913890,118670,116321,66397,49924,17337,51442,68779,0.06467421505100565,0.021796525530486468
993,"Indian River County, FL",County or equivalent,138277,162518,24490,12969,20372,-7403,2352,29438,31790,0.2128915148578578,0.0170093363321449
994,"Highlands County, FL",County or equivalent,98637,106639,7853,9120,15875,-6755,3406,11278,14684,0.1143384328396038,0.03453065279763172
995,"Sheboygan County, WI",County or equivalent,115520,115240,-269,12894,11309,1585,791,-2610,-1819,-0.02259349030470914,0.006847299168975069
996,"Grayson County, TX",County or equivalent,121029,138318,17449,16034,14524,1510,1221,14769,15990,0.12202860471457255,0.010088491188062366
997,"Bossier Parish, LA",County or equivalent,117637,127275,10286,17988,10592,7396,1748,1083,2831,0.00920628713755026,0.014859270467624981
998,"Caddo Parish, LA",County or equivalent,255652,237479,-17490,35766,28294,7472,1409,-26444,-25035,-0.10343748533162267,0.005511398307073678
999,"De Soto Parish, LA",County or equivalent,26670,27650,994,3446,3058,388,5,619,624,0.023209598800149986,0.00018747656542932132
1000,"Cochise County, AZ",County or equivalent,131823,127450,-3909,15790,13365,2425,2745,-9309,-6564,-0.07061741881158827,0.020823376800710044
1001,"Woodbury County, IA",County or equivalent,102393,103138,965,15358,9743,5615,1944,-6612,-4668,-0.06457472678796403,0.01898567284872989
1002,"Dakota County, NE",County or equivalent,21033,20070,-936,3721,1639,2082,300,-3350,-3050,-0.15927352255978697,0.014263300527742119
1003,"Dixon County, NE",County or equivalent,5988,5596,-407,761,637,124,56,-592,-536,-0.09886439545758184,0.009352037408149631
1004,"Union County, SD",County or equivalent,14488,16192,1798,1728,1253,475,400,919,1319,0.06343180563224737,0.027609055770292656
1005,"Lincoln County, SD",County or equivalent,45185,63019,18192,8281,2425,5856,107,12100,12207,0.26778798273763416,0.002368042491977426
1006,"McCook County, SD",County or equivalent,5609,5520,-98,812,763,49,94,-239,-145,-0.04261009092529863,0.016758780531289
1007,"Minnehaha County, SD",County or equivalent,169964,196659,27185,29573,14126,15447,8096,3630,11726,0.021357463933538868,0.04763361653055941
1008,"Turner County, SD",County or equivalent,8352,8368,19,936,1059,-123,24,123,147,0.014727011494252871,0.002873563218390805
1009,"St. Joseph County, IN",County or equivalent,266799,271484,4570,36085,26871,9214,5432,-10000,-4568,-0.0374813998553218,0.0203598964014108
1010,"Cass County, MI",County or equivalent,52245,51584,-703,4942,5397,-455,89,-306,-217,-0.005857019810508183,0.0017035122978275436
1011,"Spartanburg County, SC",County or equivalent,284769,326205,41876,37858,31185,6673,2234,33031,35265,0.11599226039351193,0.007844955033729093
1012,"Spokane County, WA",County or equivalent,472102,528225,57005,60875,45860,15015,5802,36435,42237,0.0771761187201071,0.012289717052670821
1013,"Stevens County, WA",County or equivalent,43472,46360,2828,4436,4679,-243,147,2953,3100,0.06792878174457123,0.003381486934118513
1014,"Menard County, IL",County or equivalent,12696,12068,-637,1231,1334,-103,-11,-524,-535,-0.0412728418399496,-0.0008664146187775677
1015,"Sangamon County, IL",County or equivalent,197769,193882,-3581,23441,20207,3234,2432,-9172,-6740,-0.04637733921898781,0.01229717498697976
1016,"Franklin County, MA",County or equivalent,71372,70267,-1114,5914,7225,-1311,1612,-1371,241,-0.01920921369724822,0.022585888023314463
1017,"Hampden County, MA",County or equivalent,464248,463986,366,52849,45653,7196,23191,-29976,-6785,-0.06456893729213696,0.04995390394788992
1018,"Hampshire County, MA",County or equivalent,159331,161401,3343,10685,12941,-2256,6986,-1466,5520,-0.009200971562345056,0.04384583037826914
1019,"Christian County, MO",County or equivalent,77841,90655,13241,10527,6429,4098,348,8783,9131,0.11283256895466401,0.004470651713107488
1020,"Dallas County, MO",County or equivalent,16723,17219,450,2155,2007,148,87,214,301,0.012796746995156372,0.0052024158344794605
1021,"Greene County, MO",County or equivalent,275320,294997,19818,35778,28568,7210,3113,9555,12668,0.0347050704634607,0.011306842946389657
1022,"Polk County, MO",County or equivalent,31158,32490,1360,4014,3680,334,3,1040,1043,0.03337826561396752,9.628345850182938e-05
1023,"Webster County, MO",County or equivalent,36320,39859,3595,5702,3468,2234,49,1328,1377,0.03656387665198238,0.0013491189427312774
1024,"Clark County, OH",County or equivalent,138272,133593,-4746,16273,17744,-1471,664,-3867,-3203,-0.027966616523952787,0.004802129136773896
1025,"Centre County, PA",County or equivalent,154242,161496,7488,12487,10114,2373,9996,-4887,5109,-0.031683977126852614,0.06480725094332282
1026,"Augusta County, VA",County or equivalent,73593,76544,2785,7010,7335,-325,388,2766,3154,0.03758509640862582,0.005272240566358213
1027,"Staunton city, VA",County or equivalent,23738,25190,1445,2969,3743,-774,612,1596,2208,0.06723397084842868,0.025781447468194454
1028,"Waynesboro city, VA",County or equivalent,20989,22741,1747,2955,2745,210,564,978,1542,0.04659583591405022,0.02687121825718233
1029,"San Joaquin County, CA",County or equivalent,687115,767967,82669,103227,55216,48011,10100,24846,34946,0.036159885899740216,0.014699140609650494
1030,"Clarendon County, SC",County or equivalent,34947,33415,-1534,3414,4067,-653,75,-940,-865,-0.026897873923369675,0.0021461069619709847
1031,"Sumter County, SC",County or equivalent,107610,106360,-1125,14906,11266,3640,1258,-5999,-4741,-0.05574760709971192,0.011690363349131122
1032,"Madison County, NY",County or equivalent,73442,70478,-2979,6804,6361,443,317,-3741,-3424,-0.050938155278995666,0.004316331254595463
1033,"Onondaga County, NY",County or equivalent,467549,459214,-7854,53964,43840,10124,13271,-31285,-18014,-0.0669127727788959,0.028384190747921607
1034,"Oswego County, NY",County or equivalent,122141,116346,-5763,13106,11092,2014,485,-8309,-7824,-0.06802793492766558,0.0039708206089683245
1035,"Gadsden County, FL",County or equivalent,47792,45277,-2460,5615,4835,780,504,-3775,-3271,-0.07898811516571813,0.01054569802477402
1036,"Jefferson County, FL",County or equivalent,14754,14543,-218,1288,1648,-360,169,-38,131,-0.002575572726040396,0.011454520807916495
1037,"Leon County, FL",County or equivalent,275981,295460,19977,30932,18935,11997,6265,1539,7804,0.005576470844007377,0.022700838101173636
1038,"Wakulla County, FL",County or equivalent,30824,34319,3538,3337,2757,580,93,2859,2952,0.09275240072670646,0.0030171295094731376
1039,"Hernando County, FL",County or equivalent,172978,198792,26014,15764,27343,-11579,2251,35264,37515,0.2038640752003145,0.01301321555342298
1040,"Hillsborough County, FL",County or equivalent,1233511,1497957,268750,173670,106438,67232,83588,116913,200501,0.09478067078445186,0.06776429233302338
1041,"Pasco County, FL",County or equivalent,465516,570412,105705,50812,61649,-10837,8730,107423,116153,0.2307611338815422,0.01875338334235558
1042,"Pinellas County, FL",County or equivalent,916428,976802,60003,85520,122048,-36528,21738,74630,96368,0.081435748362119,0.02372035773677801
1043,"Clay County, IN",County or equivalent,26863,26246,-650,3266,3120,146,5,-798,-793,-0.029706287458586163,0.0001861296206678331
1044,"Parke County, IN",County or equivalent,17279,16871,-478,2021,1688,333,11,-829,-818,-0.04797731350193877,0.000636610914983506
1045,"Sullivan County, IN",County or equivalent,21387,20578,-895,2287,2441,-154,-27,-713,-740,-0.033338009070930937,-0.001262449151353626
1046,"Vermillion County, IN",County or equivalent,16117,15329,-881,1690,2178,-488,104,-498,-394,-0.030899050691816095,0.006452813799094124
1047,"Vigo County, IN",County or equivalent,107891,106608,-1242,12774,11955,819,1610,-3626,-2016,-0.03360799325244923,0.014922468046454291
1048,"Little River County, AR",County or equivalent,13133,12180,-988,1477,1713,-236,-30,-726,-756,-0.055280590877941065,-0.002284321937105003
1049,"Miller County, AR",County or equivalent,43568,43177,-285,6020,4892,1128,-125,-1263,-1388,-0.028989166360631657,-0.0028690782225486594
1050,"Bowie County, TX",County or equivalent,92645,93481,917,12199,10387,1812,673,-1519,-846,-0.016395919909331317,0.0072642884127583785
1051,"Sumter County, FL",County or equivalent,94286,139018,45598,4768,17198,-12430,244,57205,57449,0.606717858430732,0.002587870945845619
1052,"Fulton County, OH",County or equivalent,42630,41889,-809,4964,4332,632,256,-1694,-1438,-0.039737274220032835,0.0060051606849636395
1053,"Lucas County, OH",County or equivalent,441447,428294,-13519,56915,46166,10749,4931,-29338,-24407,-0.06645871418312957,0.01117008383792392
1054,"Ottawa County, OH",County or equivalent,41359,40253,-1180,3452,5053,-1601,41,418,459,0.010106627336250876,0.000991319906187287
1055,"Wood County, OH",County or equivalent,125956,131113,5623,13774,11251,2523,1865,1228,3093,0.009749436311092765,0.014806757915462545
1056,"Jackson County, KS",County or equivalent,13461,13171,-289,1717,1412,305,17,-615,-598,-0.04568754178738578,0.0012629076591635091
1057,"Jefferson County, KS",County or equivalent,19120,19032,-76,1928,1856,72,2,-143,-141,-0.00747907949790795,0.00010460251046025104
1058,"Osage County, KS",County or equivalent,16274,15770,-524,1712,1995,-283,21,-259,-238,-0.01591495637212732,0.0012904018680103232
1059,"Shawnee County, KS",County or equivalent,178365,175999,-1944,23328,18831,4497,1641,-8019,-6378,-0.04495837187789084,0.009200235472205871
1060,"Wabaunsee County, KS",County or equivalent,7047,6906,-149,810,662,148,23,-321,-298,-0.045551298424861636,0.0032638001986660986
1061,"Mercer County, NJ",County or equivalent,367717,367239,-246,42239,30039,12200,18281,-30869,-12588,-0.08394770978768999,0.04971486224460658
1062,"Pima County, AZ",County or equivalent,981649,1061175,80909,117433,96509,20924,25365,35533,60898,0.03619725584195573,0.025839174694824732
1063,"Creek County, OK",County or equivalent,70243,71485,1500,8653,8819,-166,377,1330,1707,0.018934271030565324,0.005367082840994832
1064,"Okmulgee County, OK",County or equivalent,40082,38234,-1827,4887,5388,-501,41,-1355,-1314,-0.03380569831844718,0.0010229030487500623
1065,"Osage County, OK",County or equivalent,47487,46642,-819,4523,4895,-372,122,-549,-427,-0.011561058816097036,0.0025691241813548967
1066,"Pawnee County, OK",County or equivalent,16588,16381,-188,1987,2142,-155,61,-93,-32,-0.005606462503014227,0.0036773571256329884
1067,"Rogers County, OK",County or equivalent,87016,93155,6245,10300,8814,1486,442,4396,4838,0.05051944469982532,0.005079525604486532
1068,"Tulsa County, OK",County or equivalent,605024,657589,54138,94763,59943,34820,13870,5681,19551,0.009389710160258106,0.022924710424710424
1069,"Wagoner County, OK",County or equivalent,73428,82925,9841,9025,6685,2340,343,7177,7520,0.09774200577436401,0.00467124257776325
1070,"Greene County, AL",County or equivalent,8990,7990,-1049,1016,1119,-103,5,-960,-955,-0.1067853170189099,0.0005561735261401556
1071,"Hale County, AL",County or equivalent,15745,14670,-1092,1997,1885,112,18,-1235,-1217,-0.07843759923785329,0.001143220069863449
1072,"Pickens County, AL",County or equivalent,19749,19793,47,2246,2537,-291,84,192,276,0.009722011241075496,0.004253379917970529
1073,"Tuscaloosa County, AL",County or equivalent,195008,210758,16080,25164,17915,7249,2995,5837,8832,0.02993210534952412,0.015358344273055463
1074,"Jerome County, ID",County or equivalent,22438,24578,2223,3982,1662,2320,905,-1008,-103,-0.044923789999108656,0.040333363044834654
1075,"Twin Falls County, ID",County or equivalent,77547,88411,11171,12295,7679,4616,1924,4666,6590,0.06016996144273795,0.024810759926238282
1076,"Smith County, TX",County or equivalent,210407,235806,26077,31078,21241,9837,2161,14129,16290,0.06715080772027547,0.010270570846026986
1077,"Honolulu County, HI",County or equivalent,956320,963826,10623,133124,79117,54007,46120,-88836,-42716,-0.09289359210306174,0.04822653505102895
1078,"Herkimer County, NY",County or equivalent,64470,60945,-3524,6423,7029,-606,210,-3119,-2909,-0.048379091050100825,0.0032573289902280127
1079,"Oneida County, NY",County or equivalent,234752,227346,-7505,26260,26088,172,5282,-12950,-7668,-0.05516459923664122,0.02250034078516903
1080,"Brooks County, GA",County or equivalent,16246,15357,-957,1964,2055,-91,181,-1067,-886,-0.06567770528130001,0.011141203988674134
1081,"Echols County, GA",County or equivalent,4014,4002,-21,602,281,321,3,-348,-345,-0.08669656203288491,0.0007473841554559044
1082,"Lanier County, GA",County or equivalent,10103,10737,661,1405,945,460,133,61,194,0.00603781055132139,0.013164406611897456
1083,"Lowndes County, GA",County or equivalent,109704,118268,9011,16698,9024,7674,1969,-805,1164,-0.0073379275140377734,0.017948297236199225
1084,"Solano County, CA",County or equivalent,413963,446935,33592,52637,33374,19263,6737,7856,14593,0.018977541471097658,0.016274401335385047
1085,"Goliad County, TX",County or equivalent,7219,7626,416,721,817,-96,-4,513,509,0.07106247402687353,-0.0005540933647319574
1086,"Victoria County, TX",County or equivalent,86883,91936,5141,12970,8237,4733,547,-154,393,-0.0017724986476065512,0.0062958231184466465
1087,"Cumberland County, NJ",County or equivalent,156667,147008,-9602,20374,15718,4656,3040,-17382,-14342,-0.1109487001091487,0.019404214033587164
1088,"Camden County, NC",County or equivalent,10011,10984,1004,945,798,147,86,777,863,0.07761462391369492,0.008590550394565978
1089,"Currituck County, NC",County or equivalent,23672,29052,5505,2578,2216,362,25,5103,5128,0.21557113889827645,0.0010561000337952012
1090,"Gates County, NC",County or equivalent,12165,11464,-721,1057,1234,-177,31,-578,-547,-0.04751335799424579,0.002548294286888615
1091,"Gloucester County, VA",County or equivalent,36942,37459,600,3690,3961,-271,154,741,895,0.020058470034107517,0.004168696876184289
1092,"Isle of Wight County, VA",County or equivalent,35319,37725,2446,3598,3648,-50,618,1904,2522,0.05390866106061893,0.017497664146776518
1093,"James City County, VA",County or equivalent,67681,77612,10212,6738,7362,-624,1366,9431,10797,0.13934486783587713,0.020182916919076255
1094,"Mathews County, VA",County or equivalent,8974,8766,-210,603,1239,-636,35,400,435,0.04457321149988857,0.0039001560062402493
1095,"Southampton County, VA",County or equivalent,18642,17636,-937,1726,1935,-209,32,-768,-736,-0.04119729642742195,0.0017165540178092481
1096,"York County, VA",County or equivalent,65224,69199,4008,6650,4429,2221,2093,-337,1756,-0.005166809763277321,0.03208941493928615
1097,"Chesapeake city, VA",County or equivalent,223525,247011,24743,29585,18133,11452,4142,9231,13373,0.0412973940275137,0.018530365730902585
1098,"Franklin city, VA",County or equivalent,8579,7833,-745,1166,1379,-213,31,-563,-532,-0.06562536426156895,0.003613474763958504
1099,"Hampton city, VA",County or equivalent,137418,135464,-1999,18431,12882,5549,2777,-10330,-7553,-0.07517210263575369,0.020208415200337657
1100,"Newport News city, VA",County or equivalent,180905,179062,-1894,28369,15652,12717,5809,-20513,-14704,-0.11339100632928885,0.03211077637434012
1101,"Norfolk city, VA",County or equivalent,243019,242803,-37,36840,20383,16457,9567,-25974,-16407,-0.10688053197486616,0.03936729226932874
1102,"Poquoson city, VA",County or equivalent,12148,12257,98,974,1150,-176,45,232,277,0.019097793875535063,0.003704313467237405
1103,"Portsmouth city, VA",County or equivalent,95457,95094,-437,15348,10881,4467,1891,-6764,-4873,-0.07085913028903068,0.019809966791330128
1104,"Suffolk city, VA",County or equivalent,84859,93913,9307,11566,7817,3749,985,4600,5585,0.05420756784784171,0.011607490071766109
1105,"Virginia Beach city, VA",County or equivalent,438864,451231,13346,60755,31811,28944,12871,-28454,-15583,-0.0648355754857997,0.0293279922709541
1106,"Williamsburg city, VA",County or equivalent,13706,15259,1580,1137,921,216,830,525,1355,0.038304392236976514,0.060557420107981916
1107,"Tulare County, CA",County or equivalent,442953,468680,26504,75989,30822,45167,-1311,-17347,-18658,-0.03916216844676523,-0.0029596819527128162
1108,"Falls County, TX",County or equivalent,17895,17275,-591,2099,1918,181,41,-822,-781,-0.045934618608549874,0.0022911427773120983
1109,"McLennan County, TX",County or equivalent,235904,259730,24835,35539,21730,13809,2794,8343,11137,0.03536608111774281,0.011843800868149757
1110,"Walla Walla County, WA",County or equivalent,58915,61292,2511,6711,5870,841,562,1130,1692,0.01918017482814224,0.009539166595943309
1111,"Houston County, GA",County or equivalent,140414,160110,20537,20778,11809,8969,2298,9322,11620,0.06638939137123079,0.01636588944122381
1112,"Peach County, GA",County or equivalent,28104,27950,-104,3122,2651,471,143,-742,-599,-0.02640193566752064,0.0050882436663820104
1113,"Frederick County, MD",County or equivalent,234239,265161,31746,29021,18076,10945,6200,14793,20993,0.0631534458395058,0.026468692233146487
1114,"Montgomery County, MD",County or equivalent,975619,1051816,80537,131789,61323,70466,78718,-68578,10140,-0.07029178398534675,0.08068518550786731
1115,"District of Columbia, DC",County or equivalent,605282,712816,111049,96247,51168,45079,38285,26531,64816,0.04383246156337048,0.06325150921388709
1116,"Calvert County, MD",County or equivalent,88989,93072,4331,9331,6952,2379,623,1367,1990,0.01536144916787468,0.007000865275483487
1117,"Charles County, MD",County or equivalent,147159,164436,17872,18978,10682,8296,1803,7856,9659,0.0533844345232028,0.012252053900882718
1118,"Prince George's County, MD",County or equivalent,866442,909612,45584,124424,61060,63364,52544,-69848,-17304,-0.08061474397593837,0.06064341294627915
1119,"Arlington County, VA",County or equivalent,209319,240119,32423,31305,9585,21720,20261,-9799,10462,-0.04681371495181995,0.096794844232965
1120,"Clarke County, VA",County or equivalent,14018,14622,594,1271,1575,-304,45,858,903,0.06120701954629763,0.003210158367812812
1121,"Culpeper County, VA",County or equivalent,46834,53569,6882,6506,4314,2192,772,3934,4706,0.08399880428748345,0.016483751120980484
1122,"Fairfax County, VA",County or equivalent,1086165,1150847,69166,151795,51808,99987,91386,-122778,-31392,-0.113038074325724,0.08413638811782741
1123,"Fauquier County, VA",County or equivalent,65433,71361,6139,7779,5585,2194,328,3658,3986,0.055904513013311334,0.0050127611449880035
1124,"Loudoun County, VA",County or equivalent,315486,422784,110442,52465,13320,39145,20388,50231,70619,0.15921784167918704,0.06462410376371693
1125,"Madison County, VA",County or equivalent,13299,13312,6,1310,1483,-173,110,76,186,0.005714715392134747,0.008271298593879239
1126,"Prince William County, VA",County or equivalent,406183,475533,73527,66874,18903,47971,23038,2320,25358,0.005711711223758749,0.05671827722972157
1127,"Rappahannock County, VA",County or equivalent,7502,7260,-247,637,724,-87,32,-189,-157,-0.025193281791522262,0.004265529192215409
1128,"Spotsylvania County, VA",County or equivalent,122981,138449,15994,16141,9039,7102,1533,7451,8984,0.06058659467722656,0.0124653401744985
1129,"Stafford County, VA",County or equivalent,129857,156748,27755,17597,7450,10147,2889,14727,17616,0.11340936568687095,0.022247549227226868
1130,"Warren County, VA",County or equivalent,37520,40475,3023,4920,3855,1065,179,1662,1841,0.044296375266524524,0.0047707889125799575
1131,"Alexandria city, VA",County or equivalent,140737,158726,18728,27943,7553,20390,18437,-20041,-1604,-0.1424003637991431,0.13100321876976204
1132,"Fairfax city, VA",County or equivalent,22616,23429,875,3146,2172,974,2288,-2405,-117,-0.10634064379200564,0.10116731517509728
1133,"Falls Church city, VA",County or equivalent,12422,14631,2364,1522,817,705,607,1022,1629,0.08227338592819193,0.0488649170825954
1134,"Fredericksburg city, VA",County or equivalent,24356,29492,5314,4189,1984,2205,1348,1669,3017,0.06852520939398916,0.05534570537033996
1135,"Manassas city, VA",County or equivalent,38212,40869,3070,6965,2254,4711,2306,-3995,-1689,-0.10454830943159216,0.06034753480582016
1136,"Manassas Park city, VA",County or equivalent,14451,18004,3761,2602,366,2236,1236,248,1484,0.017161442114732545,0.0855304131201993
1137,"Jefferson County, WV",County or equivalent,53612,57486,3996,5896,4904,992,740,2283,3023,0.0425837499067373,0.013802879952249495
1138,"Black Hawk County, IA",County or equivalent,131164,130786,-300,17344,12480,4864,3053,-8135,-5082,-0.062021591290293075,0.02327620383641853
1139,"Bremer County, IA",County or equivalent,24296,25311,1031,2666,2245,421,371,258,629,0.010619031939413895,0.015270003292723084
1140,"Grundy County, IA",County or equivalent,12464,12217,-236,1332,1396,-64,3,-171,-168,-0.013719512195121951,0.0002406931964056483
1141,"Jefferson County, NY",County or equivalent,116609,108095,-8139,20811,9304,11507,3600,-23363,-19763,-0.2003533174969342,0.030872402644735824
1142,"Lincoln County, WI",County or equivalent,28777,27566,-1177,2733,3396,-663,17,-516,-499,-0.017930986551760085,0.0005907495569378322
1143,"Marathon County, WI",County or equivalent,134064,135593,1520,16254,12128,4126,702,-3247,-2545,-0.024219775629550067,0.0052363050483351225
1144,"Jefferson County, OH",County or equivalent,69669,64939,-4779,6773,9772,-2999,-34,-1687,-1721,-0.02421449999282321,-0.00048802193227978006
1145,"Brooke County, WV",County or equivalent,23973,21674,-2372,1958,3402,-1444,-4,-903,-907,-0.0376673757977725,-0.00016685437784173864
1146,"Hancock County, WV",County or equivalent,30686,28571,-2120,2735,4264,-1529,54,-613,-559,-0.01997653653131721,0.0017597601512090203
1147,"Chelan County, WA",County or equivalent,72747,77574,5114,9375,7062,2313,105,2746,2851,0.03774726105543871,0.001443358489009856
1148,"Douglas County, WA",County or equivalent,38513,43560,5133,5335,3182,2153,523,2477,3000,0.06431594526523511,0.013579830187209513
1149,"Belmont County, OH",County or equivalent,70337,65932,-4470,6926,9209,-2283,31,-2151,-2120,-0.030581344100544517,0.00044073531711616936
1150,"Marshall County, WV",County or equivalent,33091,30103,-3025,3140,4203,-1063,51,-1988,-1937,-0.060076758030884525,0.0015412045571303375
1151,"Ohio County, WV",County or equivalent,44477,41182,-3251,4564,5942,-1378,122,-1979,-1857,-0.0444949074802707,0.002742990759268836
1152,"Butler County, KS",County or equivalent,65901,66992,1108,7628,6557,1071,372,-331,41,-0.005022685543466715,0.005644830882687668
1153,"Harvey County, KS",County or equivalent,34740,34291,-393,4211,4053,158,504,-1046,-542,-0.030109383995394364,0.014507772020725387
1154,"Sedgwick County, KS",County or equivalent,499138,519907,21551,74904,44911,29993,9048,-17318,-8270,-0.034695815586070385,0.018127251381381503
1155,"Sumner County, KS",County or equivalent,24119,22578,-1559,2732,2724,8,73,-1646,-1573,-0.06824495211244247,0.0030266594800779467
1156,"Archer County, TX",County or equivalent,9118,8730,-331,822,913,-91,23,-265,-242,-0.02906339109453828,0.002522483000658039
1157,"Clay County, TX",County or equivalent,10737,10550,-204,873,1254,-381,96,78,174,0.0072645990500139705,0.008941044984632579
1158,"Wichita County, TX",County or equivalent,131802,133205,1546,17489,13928,3561,3506,-5486,-1980,-0.04162304062153837,0.026600506820837318
1159,"Lycoming County, PA",County or equivalent,116215,113209,-2886,12652,13133,-481,869,-3242,-2373,-0.027896571010626856,0.007477520113582584
1160,"New Hanover County, NC",County or equivalent,203295,236613,33930,22854,19341,3513,1575,28513,30088,0.14025431023881552,0.007747362207629306
1161,"Pender County, NC",County or equivalent,52415,64671,12476,6315,5598,717,174,11508,11682,0.2195554707621864,0.00331966040255652
1162,"Frederick County, VA",County or equivalent,78545,91119,12853,9812,6945,2867,875,9128,10003,0.11621363549557577,0.011140110764529887
1163,"Winchester city, VA",County or equivalent,26150,27700,1477,3811,2778,1033,1358,-910,448,-0.034799235181644364,0.05193116634799235
1164,"Hampshire County, WV",County or equivalent,23945,23190,-762,2277,2733,-456,-39,-256,-295,-0.010691167258300271,-0.001628732512006682
1165,"Davidson County, NC",County or equivalent,162841,169234,6410,17877,18096,-219,909,5876,6785,0.036084278529363,0.0055821322639875715
1166,"Davie County, NC",County or equivalent,41252,43286,2068,3968,4634,-666,24,2732,2756,0.06622709201978086,0.0005817899738194513
1167,"Forsyth County, NC",County or equivalent,351378,383843,33208,45918,33775,12143,4784,16392,21176,0.04665061557638782,0.013614967357091223
1168,"Stokes County, NC",County or equivalent,47330,45743,-1657,4056,5540,-1484,160,-315,-155,-0.006655398267483625,0.003380519754912318
1169,"Yadkin County, NC",County or equivalent,38435,37625,-787,3971,4397,-426,2,-340,-338,-0.008846103811630025,5.203590477429426e-05
1170,"Windham County, CT",County or equivalent,118543,116540,-1839,11449,10783,666,3184,-5722,-2538,-0.04826940435116371,0.026859451844478376
1171,"Worcester County, MA",County or equivalent,800404,829212,30827,87896,72329,15567,35227,-19599,15628,-0.024486384375890177,0.04401152418028896
1172,"Yakima County, WA",County or equivalent,244249,251879,8639,40578,20133,20445,848,-12673,-11825,-0.051885575785366574,0.003471866824429169
1173,"York County, PA",County or equivalent,435420,450448,15432,49895,41514,8381,6139,1319,7458,0.0030292591061503835,0.01409903082081668
1174,"Mahoning County, OH",County or equivalent,238315,226075,-12713,24555,31303,-6748,2630,-8500,-5870,-0.035667079285819185,0.011035813943729936
1175,"Trumbull County, OH",County or equivalent,209838,196800,-13531,21459,26330,-4871,211,-8815,-8604,-0.042008597108245414,0.0010055376052002024
1176,"Mercer County, PA",County or equivalent,116607,108545,-8118,11329,14595,-3266,410,-5214,-4804,-0.044714296740332914,0.0035160839400722077
1177,"Sutter County, CA",County or equivalent,94742,96385,1634,13256,8230,5026,1964,-5395,-3431,-0.0569441219311393,0.020729982478731715
1178,"Yuba County, CA",County or equivalent,72345,80160,8018,12192,6183,6009,681,1360,2041,0.01879881125164144,0.009413228281152809
1179,"Yuma County, AZ",County or equivalent,197148,217824,22074,31510,15302,16208,7840,-2219,5621,-0.011255503479619372,0.039767078539980114
1180,"Brown County, SD",County or equivalent,36655,38738,2206,5109,3779,1330,1166,-296,870,-0.008075296685308963,0.031810121402264364
1181,"Edmunds County, SD",County or equivalent,4066,3817,-254,447,445,2,45,-298,-253,-0.07329070339399901,0.011067388096409248
1182,"Grays Harbor County, WA",County or equivalent,72849,75950,3150,7903,8666,-763,85,3833,3918,0.05261568449807135,0.0011667970733983994
1183,"Pontotoc County, OK",County or equivalent,37594,38397,909,5427,4600,827,379,-274,105,-0.007288397084641166,0.010081395967441613
1184,"Lenawee County, MI",County or equivalent,99642,97808,-2090,10573,10449,124,577,-2785,-2208,-0.02795006121916461,0.005790730816322434
1185,"Otero County, NM",County or equivalent,64405,67967,4131,9249,6127,3122,4099,-3174,925,-0.04928188805216986,0.06364412700877263
1186,"Stanly County, NC",County or equivalent,60578,63239,2654,6919,7159,-240,179,2770,2949,0.0457261712172736,0.00295486810393212
1187,"Freeborn County, MN",County or equivalent,31203,30364,-890,3424,3728,-304,270,-843,-573,-0.027016633016056148,0.008653014133256417
1188,"Marshall County, AL",County or equivalent,93119,96990,3973,13688,11537,2151,858,1050,1908,0.011275894285806332,0.009214016473544605
1189,"Coosa County, AL",County or equivalent,11779,10650,-1106,939,1434,-495,74,-686,-612,-0.05823923932422107,0.0062823669241871116
1190,"Tallapoosa County, AL",County or equivalent,41480,40133,-1488,4519,5535,-1016,1,-461,-460,-0.011113789778206365,2.4108003857280615e-05
1191,"Douglas County, MN",County or equivalent,35990,38328,2317,4256,4271,-15,104,2259,2363,0.06276743539872187,0.0028896915809947213
1192,"Duval County, TX",County or equivalent,11705,11058,-700,1665,1371,294,32,-1043,-1011,-0.08910721913712089,0.002733874412644169
1193,"Jim Wells County, TX",County or equivalent,40914,40452,-415,6214,4111,2103,435,-2959,-2524,-0.0723224324192208,0.010632057486434959
1194,"Gratiot County, MI",County or equivalent,42431,40283,-2195,4134,4588,-454,115,-1862,-1747,-0.04388301006339705,0.002710282576418185
1195,"Alpena County, MI",County or equivalent,29511,28238,-1356,2688,3823,-1135,75,-270,-195,-0.009149130832570906,0.002541425231269696
1196,"Jackson County, OK",County or equivalent,26485,24305,-2141,4185,2621,1564,643,-4386,-3743,-0.16560317160656976,0.024277893147064376
1197,"Schley County, GA",County or equivalent,5020,5196,183,518,376,142,79,-40,39,-0.00796812749003984,0.015737051792828687
1198,"Sumter County, GA",County or equivalent,32608,29282,-3460,3960,3660,300,212,-4014,-3802,-0.12309862610402356,0.006501472031403337
1199,"Montgomery County, NY",County or equivalent,50312,49170,-1098,6158,5960,198,1181,-2466,-1285,-0.049014151693432984,0.02347352520273493
1200,"Andrews County, TX",County or equivalent,14849,18879,4093,3185,1379,1806,223,2015,2238,0.13569937369519833,0.015017846319617485
1201,"Steuben County, IN",County or equivalent,34110,34831,684,3881,3286,595,172,-51,121,-0.0014951627088830256,0.005042509527997655
1202,"DeSoto County, FL",County or equivalent,34935,38520,3658,3958,3358,600,1440,1632,3072,0.04671532846715328,0.041219407471017606
1203,"Carter County, OK",County or equivalent,47810,48353,624,6758,6341,417,403,-168,235,-0.0035139092240117128,0.00842919891236143
1204,"Love County, OK",County or equivalent,9411,10230,814,1271,1218,53,105,656,761,0.06970566358516629,0.011157156518967166
1205,"Clark County, AR",County or equivalent,22928,22103,-889,2412,2571,-159,203,-938,-735,-0.040910676901605034,0.008853803210048848
1206,"Ashland County, OH",County or equivalent,53317,53362,226,6248,5811,437,868,-1070,-202,-0.020068646022844496,0.0162799857456346
1207,"Ashtabula County, OH",County or equivalent,101411,96513,-4984,11394,12204,-810,636,-4810,-4174,-0.04743075208803778,0.0062715090078985505
1208,"Clatsop County, OR",County or equivalent,37097,40423,3389,4161,4063,98,232,3055,3287,0.08235167264199261,0.006253874976413187
1209,"Atchison County, KS",County or equivalent,16855,16015,-906,2017,1855,162,13,-1088,-1075,-0.06455057846336397,0.00077128448531593
1210,"Athens County, OH",County or equivalent,65175,65481,718,5382,5037,345,2610,-2347,263,-0.036010740314537784,0.04004602991944764
1211,"McMinn County, TN",County or equivalent,52173,54208,1925,5877,6929,-1052,512,2504,3016,0.04799417323136488,0.009813505069672051
1212,"Henderson County, TX",County or equivalent,78652,83792,5225,9226,10909,-1683,279,6672,6951,0.08482937496821441,0.0035472715251996132
1213,"Escambia County, AL",County or equivalent,38352,36281,-2044,4551,4842,-291,24,-1764,-1740,-0.04599499374217772,0.0006257822277847308
1214,"DeKalb County, IN",County or equivalent,42335,43670,1415,5447,4219,1228,-2,212,210,0.005007676863115625,-4.724223455769458e-05
1215,"Cayuga County, NY",County or equivalent,79905,76029,-3993,7805,7844,-39,511,-4462,-3951,-0.0558413115574745,0.006395094174332019
1216,"Kennebec County, ME",County or equivalent,122074,122955,804,12047,13701,-1654,705,1851,2556,0.015162933958090994,0.005775185543195111
1217,"Mower County, MN",County or equivalent,39209,40150,985,5273,4056,1217,1298,-1510,-212,-0.038511566222040855,0.033104644341860286
1218,"Decatur County, GA",County or equivalent,27815,26457,-1384,3753,3254,499,-33,-1859,-1892,-0.06683444184792378,-0.0011864102103181734
1219,"Sauk County, WI",County or equivalent,62051,64449,2494,7786,6333,1453,576,525,1101,0.008460782259754072,0.009282686822130185
1220,"Nelson County, KY",County or equivalent,43626,46450,3009,5882,4127,1755,-7,1281,1274,0.029363223765644337,-0.00016045477467565214
1221,"Washington County, VT",County or equivalent,59573,58328,-1197,5671,5567,104,178,-1456,-1278,-0.024440602286270628,0.0029879307740083593
1222,"Washington County, OK",County or equivalent,51071,52222,1243,6402,6440,-38,1020,306,1326,0.005991658671261577,0.019972195570871924
1223,"Genesee County, NY",County or equivalent,59932,56994,-2943,6066,6427,-361,255,-2842,-2587,-0.0474204097977708,0.004254822131749316
1224,"Independence County, AR",County or equivalent,36811,37757,1114,4746,4320,426,205,499,704,0.01355573062399826,0.00556898753090109
1225,"Sharp County, AR",County or equivalent,17244,17424,166,1814,2722,-908,43,1037,1080,0.060136859197401984,0.002493620969612619
1226,"Matagorda County, TX",County or equivalent,36706,36725,23,5455,3882,1573,199,-1746,-1547,-0.04756715523347682,0.0054214569825096716
1227,"Gage County, NE",County or equivalent,22269,21431,-880,2401,2833,-432,49,-493,-444,-0.02213839867079797,0.002200368224886613
1228,"Dodge County, WI",County or equivalent,88723,87336,-1408,8340,9332,-992,259,-617,-358,-0.006954228328618284,0.0029191979531801226
1229,"Lawrence County, IN",County or equivalent,46105,45496,-638,5051,5714,-663,86,-16,70,-0.0003470339442576727,0.0018653074503849907
1230,"Bee County, TX",County or equivalent,31862,32513,655,3686,2591,1095,61,-499,-438,-0.015661289310150022,0.0019145063084552128
1231,"Logan County, OH",County or equivalent,45743,45326,-522,5582,5064,518,143,-1160,-1017,-0.02535907133331876,0.003126161379883261
1232,"Beltrami County, MN",County or equivalent,44572,47442,3000,6997,4170,2827,388,-191,197,-0.0042852014717760034,0.008705016602351252
1233,"Marlboro County, SC",County or equivalent,28918,25581,-3354,3025,3571,-546,72,-2886,-2814,-0.0997994328791756,0.002489798741268414
1234,"Bennington County, VT",County or equivalent,37078,35338,-1781,3371,4641,-1270,363,-855,-492,-0.02305949619720589,0.00979017206969092
1235,"Coos County, NH",County or equivalent,32970,31174,-1878,2524,4491,-1967,91,-56,35,-0.0016985138004246285,0.002760084925690021
1236,"Mecosta County, MI",County or equivalent,42851,43907,1111,4305,3956,349,475,304,779,0.0070943501901939285,0.011084922172178012
1237,"Howard County, TX",County or equivalent,34983,36540,1534,4681,3915,766,872,-134,738,-0.0038304319240774092,0.024926392819369408
1238,"Wise County, VA",County or equivalent,41574,37206,-4230,4094,5029,-935,104,-3433,-3329,-0.08257564824168953,0.002501563477173233
1239,"Norton city, VA",County or equivalent,4013,3985,-9,505,449,56,72,-143,-71,-0.03563418888612011,0.01794168950909544
1240,"Bingham County, ID",County or equivalent,45764,47202,1597,7045,3709,3336,148,-1925,-1777,-0.04206363080150337,0.0032339830434402585
1241,"Bland County, VA",County or equivalent,6801,6239,-587,468,856,-388,-7,-187,-194,-0.02749595647698868,-0.0010292604028819294
1242,"Tazewell County, VA",County or equivalent,45118,40529,-4529,4328,6106,-1778,93,-2845,-2752,-0.06305687308834612,0.002061261580743827
1243,"Mercer County, WV",County or equivalent,62335,58258,-4007,7336,9290,-1954,189,-2197,-2008,-0.03524504692387904,0.003032004491858507
1244,"Wells County, IN",County or equivalent,27680,28142,505,3509,2925,584,175,-241,-66,-0.008706647398843931,0.006322254335260116
1245,"Mississippi County, AR",County or equivalent,46350,40066,-6414,6474,5312,1162,65,-7709,-7644,-0.16632146709816611,0.0014023732470334412
1246,"Washington Parish, LA",County or equivalent,47083,45773,-1361,5891,6086,-195,-42,-1101,-1143,-0.023384236348575917,-0.0008920417135696537
1247,"Fannin County, TX",County or equivalent,33922,35913,2001,3396,4390,-994,397,2629,3026,0.07750132657272568,0.011703319379753552
1248,"Watauga County, NC",County or equivalent,50972,56441,5380,3632,3570,62,372,4904,5276,0.09620968374794003,0.007298124460488111
1249,"Hutchinson County, TX",County or equivalent,22211,20677,-1572,2899,2447,452,75,-2104,-2029,-0.09472783755796678,0.0033767052361442533
1250,"Gallatin County, MT",County or equivalent,89662,116806,27291,11805,5684,6121,2133,18801,20934,0.20968749302937698,0.02378934219624813
1251,"McKean County, PA",County or equivalent,43347,40333,-3130,4209,5395,-1186,176,-2103,-1927,-0.048515468198491236,0.004060257918656425
1252,"Cass County, MN",County or equivalent,28654,29928,1361,3268,3240,28,74,1273,1347,0.044426607105465206,0.0025825364696028482
1253,"Crow Wing County, MN",County or equivalent,62608,65644,3132,7163,6886,277,265,2652,2917,0.04235880398671096,0.0042326859187324295
1254,"Taney County, MO",County or equivalent,51905,56104,4432,6469,5782,687,327,3423,3750,0.06594740391099123,0.006299971101049995
1255,"Summit County, CO",County or equivalent,28075,30631,2637,2824,643,2181,1070,-653,417,-0.023259127337488868,0.03811219946571683
1256,"Washington County, TX",County or equivalent,33695,35771,2084,4056,3938,118,212,1766,1978,0.05241133699361923,0.006291734678735717
1257,"Transylvania County, NC",County or equivalent,33087,34498,1409,2741,4234,-1493,59,2854,2913,0.08625744250007555,0.0017831776830779461
1258,"Lincoln County, MS",County or equivalent,34896,33936,-931,4446,4269,177,83,-1173,-1090,-0.03361416781292985,0.002378496102705181
1259,"Curry County, OR",County or equivalent,22378,23305,941,1810,3828,-2018,-139,3093,2954,0.13821610510322638,-0.0062114576816516215
1260,"Brookings County, SD",County or equivalent,32003,35603,3637,4297,2010,2287,2050,-695,1355,-0.021716714058057057,0.06405649470362154
1261,"Haywood County, TN",County or equivalent,18811,17002,-1803,2146,2093,53,17,-1880,-1863,-0.09994152357663068,0.0009037265429801713
1262,"Brown County, TX",County or equivalent,38076,37633,-473,4193,4991,-798,248,105,353,0.002757642609517807,0.006513289211051581
1263,"Crawford County, OH",County or equivalent,43754,41338,-2445,4838,5621,-783,219,-1875,-1656,-0.0428532248480139,0.0050052566622480225
1264,"Cassia County, ID",County or equivalent,23080,24277,1313,3931,2038,1893,195,-779,-584,-0.033752166377816285,0.008448873483535528
1265,"Minidoka County, ID",County or equivalent,20084,21216,1161,3255,1859,1396,128,-367,-239,-0.01827325234017128,0.006373232423819956
1266,"Henderson County, IL",County or equivalent,7344,6535,-794,650,872,-222,10,-587,-577,-0.07992919389978212,0.0013616557734204796
1267,"Des Moines County, IA",County or equivalent,40243,38708,-1617,4699,4776,-77,316,-1838,-1522,-0.04567253932360908,0.007852297293939318
1268,"Silver Bow County, MT",County or equivalent,34235,35180,969,3977,4273,-296,788,502,1290,0.014663356214400469,0.023017379874397545
1269,"Missaukee County, MI",County or equivalent,14818,15152,301,1806,1686,120,80,107,187,0.007220947496288299,0.0053988392495613454
1270,"Wexford County, MI",County or equivalent,32735,33743,1013,4071,3645,426,85,520,605,0.015885138231250956,0.0025966091339544826
1271,"Gordon County, GA",County or equivalent,55256,58780,3559,7090,5383,1707,434,1446,1880,0.026169103807731287,0.00785435065875199
1272,"Dorchester County, MD",County or equivalent,32689,31853,-770,3800,3963,-163,302,-890,-588,-0.02722628407109425,0.00923858178592187
1273,"Guernsey County, OH",County or equivalent,40152,38779,-1313,4644,4798,-154,84,-1223,-1139,-0.03045925483163977,0.0020920502092050207
1274,"Calhoun County, AR",County or equivalent,5361,5113,-255,432,638,-206,-1,-47,-48,-0.008767021078157059,-0.00018653236336504386
1275,"Ouachita County, AR",County or equivalent,26048,23167,-2961,2882,3632,-750,46,-2262,-2216,-0.08683968058968057,0.001765970515970516
1276,"Green County, KY",County or equivalent,11260,10995,-290,1147,1455,-308,21,-1,20,-8.880994671403197e-05,0.0018650088809946716
1277,"Taylor County, KY",County or equivalent,24635,25707,1233,3340,3082,258,371,601,972,0.024396184290643396,0.015059874162776538
1278,"Fremont County, CO",County or equivalent,46834,47867,1042,3854,5672,-1818,196,2642,2838,0.05641200836998761,0.004184993807917325
1279,"Eddy County, NM",County or equivalent,53912,58418,4590,8489,5802,2687,653,1221,1874,0.02264801899391601,0.012112331206410448
1280,"Carroll County, IA",County or equivalent,20823,19914,-902,2585,2468,117,48,-1067,-1019,-0.05124141574220813,0.002305143351102147
1281,"Iron County, UT",County or equivalent,46264,56814,10651,8582,3176,5406,118,5111,5229,0.11047466712778836,0.002550579284108594
1282,"Polk County, GA",County or equivalent,41537,42840,1353,5778,4970,808,217,332,549,0.007992873823338228,0.005224257890555408
1283,"Mercer County, OH",County or equivalent,40791,41274,456,6017,4203,1814,184,-1534,-1350,-0.0376063347307004,0.0045107989507489395
1284,"Muhlenberg County, KY",County or equivalent,31659,30457,-1044,3589,3959,-370,-3,-666,-669,-0.02103667203638776,-9.475978394769259e-05
1285,"Marion County, IL",County or equivalent,39416,37045,-2392,4989,5259,-270,155,-2267,-2112,-0.05751471483661458,0.00393241323320479
1286,"Lewis County, WA",County or equivalent,75503,82109,6652,9184,8969,215,588,5868,6456,0.07771876614174271,0.007787770022383215
1287,"Coles County, IL",County or equivalent,53865,50383,-3493,5092,5217,-125,600,-4000,-3400,-0.0742597233825304,0.01113895850737956
1288,"Cumberland County, IL",County or equivalent,11053,10649,-396,1245,1178,67,50,-510,-460,-0.04614131909888718,0.004523658735185018
1289,"Ross County, OH",County or equivalent,78102,76420,-1659,8579,8659,-80,154,-1703,-1549,-0.021804819338813345,0.0019717804921768967
1290,"Doddridge County, WV",County or equivalent,8198,8368,167,691,889,-198,10,340,350,0.04147353012929983,0.0012198097096852894
1291,"Harrison County, WV",County or equivalent,69244,66870,-2219,7876,8897,-1021,91,-1236,-1145,-0.01784992201490382,0.0013141932875050547
1292,"Taylor County, WV",County or equivalent,16876,16699,-177,1686,2058,-372,25,178,203,0.010547523109741644,0.0014813936951884332
1293,"Coahoma County, MS",County or equivalent,26111,21564,-4587,4115,3108,1007,-13,-5621,-5634,-0.21527325648194248,-0.0004978744590402513
1294,"Lake County, CA",County or equivalent,64736,64479,-183,7553,8751,-1198,-166,1224,1058,0.018907563025210083,-0.002564260998517054
1295,"Bolivar County, MS",County or equivalent,34104,30142,-4009,4953,4203,750,118,-4886,-4768,-0.14326765188834156,0.003460004691531785
1296,"Hendry County, FL",County or equivalent,39005,42813,3672,6050,3076,2974,3270,-2683,587,-0.06878605307011923,0.08383540571721575
1297,"Clinton County, IA",County or equivalent,49091,46392,-2721,5717,5692,25,373,-3137,-2764,-0.0639017335153083,0.007598134077529486
1298,"Curry County, NM",County or equivalent,48977,48793,417,9060,4055,5005,1541,-6194,-4653,-0.12646752557322824,0.03146374829001368
1299,"Montgomery County, KS",County or equivalent,35353,31502,-3966,4226,4483,-257,566,-4307,-3741,-0.12182841625887478,0.016009956722201794
1300,"Branch County, MI",County or equivalent,45173,43424,-1818,5513,4601,912,417,-3154,-2737,-0.06982046797865983,0.009231177916011777
1301,"Lowndes County, MS",County or equivalent,59796,58309,-1470,8139,6323,1816,953,-4226,-3273,-0.07067362365375611,0.015937520904408326
1302,"Platte County, NE",County or equivalent,32305,33364,1127,4900,2898,2002,627,-1500,-873,-0.04643244079863798,0.019408760253830683
1303,"Merrimack County, NH",County or equivalent,146395,152622,6170,13641,13959,-318,4151,2450,6601,0.016735544246729742,0.028354793538030675
1304,"Fayette County, IN",County or equivalent,24325,22892,-1410,2580,3280,-700,49,-748,-699,-0.030750256937307294,0.002014388489208633
1305,"Jackson County, TN",County or equivalent,11628,11864,228,1009,1596,-587,9,804,813,0.06914344685242517,0.0007739938080495358
1306,"Overton County, TN",County or equivalent,22085,22566,490,2419,3085,-666,6,1168,1174,0.05288657459814353,0.00027167760923703865
1307,"Putnam County, TN",County or equivalent,72552,80929,8589,9122,8121,1001,1770,5849,7619,0.08061803947513507,0.0243962950711214
1308,"Coos County, OR",County or equivalent,63010,64711,1656,6231,9259,-3028,187,4529,4716,0.07187747976511663,0.002967782891604507
1309,"Crisp County, GA",County or equivalent,23436,22034,-1401,2941,2608,333,72,-1827,-1755,-0.07795698924731183,0.0030721966205837174
1310,"Alcorn County, MS",County or equivalent,37109,36889,-173,4445,4756,-311,118,51,169,0.0013743296774367405,0.003179821606618341
1311,"Habersham County, GA",County or equivalent,43058,46047,3019,5139,4540,599,529,1883,2412,0.04373171071577872,0.012285754099122114
1312,"Steuben County, NY",County or equivalent,98969,94657,-4289,10960,10277,683,634,-5592,-4958,-0.05650254119976963,0.006406046337742121
1313,"Navarro County, TX",County or equivalent,47870,50694,2854,7023,5463,1560,172,1148,1320,0.02398161687904742,0.003593064549822436
1314,"Cortland County, NY",County or equivalent,49277,47173,-2114,4827,4559,268,245,-2632,-2387,-0.05341234247214725,0.0049718935811839185
1315,"Coshocton County, OH",County or equivalent,36938,36449,-451,4656,4206,450,66,-951,-885,-0.025745844387893225,0.0017867778439547351
1316,"Moffat County, CO",County or equivalent,13795,13144,-647,1803,1016,787,55,-1510,-1455,-0.10945994925697716,0.003986951794128307
1317,"Montgomery County, IN",County or equivalent,38096,38365,244,4635,4104,531,170,-439,-269,-0.011523519529609408,0.004462410751784964
1318,"Del Norte County, CA",County or equivalent,28568,27968,-642,3111,2968,143,157,-984,-827,-0.03444413329599552,0.005495659479137496
1319,"Cumberland County, TN",County or equivalent,56193,61603,5545,5623,8369,-2746,318,7935,8253,0.14120975922267898,0.005659067855426833
1320,"Cullman County, AL",County or equivalent,80456,84515,4111,10046,10264,-218,241,4148,4389,0.051556130058665606,0.00299542607139306
1321,"Jackson County, NC",County or equivalent,40376,44033,3760,3947,3765,182,513,3053,3566,0.07561422627303349,0.012705567663958788
1322,"Swain County, NC",County or equivalent,14006,14179,201,1864,1995,-131,35,301,336,0.021490789661573608,0.0024989290304155364
1323,"Boyle County, KY",County or equivalent,28668,30367,1933,3197,3327,-130,176,1862,2038,0.06495046742011999,0.006139249337240129
1324,"Lincoln County, KY",County or equivalent,24730,24466,-275,3356,2999,357,-14,-609,-623,-0.024625960372017797,-0.0005661140315406389
1325,"Pittsylvania County, VA",County or equivalent,63591,59850,-3621,5269,7394,-2125,129,-1605,-1476,-0.02523942067273671,0.0020285889512666887
1326,"Danville city, VA",County or equivalent,42925,39869,-3202,5182,7100,-1918,455,-1712,-1257,-0.039883517763541064,0.010599883517763541
1327,"Rhea County, TN",County or equivalent,31860,33443,1639,3949,4077,-128,284,1496,1780,0.04695543000627746,0.008913998744507219
1328,"Adams County, IN",County or equivalent,34442,35839,1455,6819,3165,3654,79,-2287,-2208,-0.0664014865571105,0.00229371116659892
1329,"Defiance County, OH",County or equivalent,39083,37778,-1248,4447,4076,371,258,-1885,-1627,-0.04823068853465701,0.006601335619067113
1330,"Val Verde County, TX",County or equivalent,48963,49028,149,8602,3701,4901,752,-5549,-4797,-0.11333047403141147,0.015358536037416009
1331,"Luna County, NM",County or equivalent,25082,23905,-1190,3894,3070,824,248,-2265,-2017,-0.09030380352443984,0.009887568774419904
1332,"Beauregard Parish, LA",County or equivalent,35832,37881,2228,5160,3862,1298,365,572,937,0.015963384684081268,0.010186425541415495
1333,"Billings County, ND",County or equivalent,783,890,106,126,47,79,30,-6,24,-0.007662835249042145,0.038314176245210725
1334,"Stark County, ND",County or equivalent,24359,32107,7909,4941,2394,2547,600,4561,5161,0.18724085553594155,0.024631553019417874
1335,"Lee County, IL",County or equivalent,35978,33647,-2387,3544,3806,-262,25,-2150,-2125,-0.05975874145311024,0.0006948690866640725
1336,"Ford County, KS",County or equivalent,34006,33094,-750,6512,2474,4038,1883,-6714,-4831,-0.19743574663294716,0.05537258130918074
1337,"Atkinson County, GA",County or equivalent,8363,8393,13,1292,770,522,193,-710,-517,-0.08489776396030133,0.023077842879349515
1338,"Coffee County, GA",County or equivalent,42729,43218,872,6011,4146,1865,130,-1167,-1037,-0.027311661868988275,0.003042430199630228
1339,"Johnson County, GA",County or equivalent,9991,9667,-311,986,1043,-57,-14,-237,-251,-0.023721349214292864,-0.0014012611350215196
1340,"Laurens County, GA",County or equivalent,48388,47512,-924,6576,5790,786,107,-1807,-1700,-0.03734396957923452,0.0022112920558816237
1341,"Treutlen County, GA",County or equivalent,6892,6822,-61,773,745,28,52,-141,-89,-0.020458502611723738,0.00754497968659315
1342,"Clearfield County, PA",County or equivalent,81543,78612,-2997,7535,9714,-2179,578,-1341,-763,-0.016445311062874803,0.007088284708681309
1343,"Moore County, TX",County or equivalent,22008,20654,-1250,4223,1460,2763,943,-5001,-4058,-0.22723555070883314,0.042848055252635416
1344,"Stephens County, OK",County or equivalent,45105,43100,-1951,5446,5807,-361,276,-1850,-1574,-0.04101540849129808,0.006119055537080146
1345,"La Plata County, CO",County or equivalent,51416,56564,5229,5287,3448,1839,140,3205,3345,0.06233468181110938,0.0027228878170219386
1346,"Bryan County, OK",County or equivalent,42579,48998,6582,6074,5261,813,287,5471,5758,0.12849057046901055,0.006740411940158294
1347,"Dyer County, TN",County or equivalent,38320,36693,-1638,4815,4704,111,70,-1810,-1740,-0.04723382045929018,0.0018267223382045926
1348,"Maverick County, TX",County or equivalent,54424,58378,4120,10988,3866,7122,1330,-4337,-3007,-0.07968910774658239,0.024437748052329854
1349,"Talbot County, MD",County or equivalent,37876,36972,-805,3423,4596,-1173,212,193,405,0.0050955750343225255,0.005597211954799872
1350,"Eagle County, CO",County or equivalent,52098,54929,2729,6415,1227,5188,1233,-3711,-2478,-0.07123114131060693,0.023666935390993897
1351,"Effingham County, IL",County or equivalent,34222,34065,-179,4623,3672,951,216,-1339,-1123,-0.03912687744725615,0.006311729296943487
1352,"Wharton County, TX",County or equivalent,41280,41685,405,5799,4353,1446,88,-1109,-1021,-0.02686531007751938,0.002131782945736434
1353,"Union County, AR",County or equivalent,41570,38219,-3415,5146,5474,-328,45,-3155,-3110,-0.07589607890305508,0.001082511426509502
1354,"Pasquotank County, NC",County or equivalent,40632,40372,-289,5002,4294,708,672,-1701,-1029,-0.04186355581807442,0.016538688718251624
1355,"Perquimans County, NC",County or equivalent,13480,13667,215,1285,1604,-319,-9,553,544,0.04102373887240356,-0.0006676557863501484
1356,"Beckham County, OK",County or equivalent,22056,21468,-651,3451,2503,948,12,-1646,-1634,-0.07462821907870874,0.000544069640914037
1357,"Randolph County, WV",County or equivalent,29360,28387,-1015,3022,3760,-738,99,-358,-259,-0.012193460490463215,0.003371934604904632
1358,"Elko County, NV",County or equivalent,49093,53006,4064,7206,2804,4402,-66,-366,-432,-0.0074552380176399905,-0.0013443871835088505
1359,"Eureka County, NV",County or equivalent,1990,2065,78,175,134,41,1,29,30,0.01457286432160804,0.0005025125628140704
1360,"Kittitas County, WA",County or equivalent,40992,49204,8294,4190,3144,1046,709,6517,7226,0.15898224043715847,0.01729605776736924
1361,"Chase County, KS",County or equivalent,2784,2586,-204,255,350,-95,7,-114,-107,-0.040948275862068964,0.002514367816091954
1362,"Lyon County, KS",County or equivalent,33647,33045,-647,4217,2933,1284,732,-2696,-1964,-0.08012601420631854,0.02175528278895593
1363,"Coffee County, AL",County or equivalent,50204,53230,3279,6389,5330,1059,1027,1176,2203,0.023424428332403796,0.020456537327702973
1364,"Delta County, MI",County or equivalent,37049,35612,-1457,3652,4540,-888,23,-567,-544,-0.01530405678965694,0.0006207994817673891
1365,"Rio Arriba County, NM",County or equivalent,40286,38521,-1699,5174,4197,977,320,-3000,-2680,-0.07446755696768108,0.00794320607655265
1366,"Barbour County, AL",County or equivalent,27325,24589,-2865,2860,3241,-381,36,-2533,-2497,-0.09269899359560843,0.0013174748398902105
1367,"Quitman County, GA",County or equivalent,2512,2271,-239,239,330,-91,0,-148,-148,-0.0589171974522293,0.0
1368,"Humboldt County, CA",County or equivalent,135010,134977,364,14896,13697,1199,451,-1251,-800,-0.009265980297755721,0.0033404932967928303
1369,"Uinta County, WY",County or equivalent,21090,20215,-906,2959,1488,1471,-48,-2356,-2404,-0.11171171171171172,-0.002275960170697013
1370,"Jefferson County, IA",County or equivalent,16835,18347,1511,1534,1703,-169,2268,-589,1679,-0.034986634986634985,0.13471933471933473
1371,"Martin County, MN",County or equivalent,20805,19484,-1359,2343,2559,-216,12,-1152,-1140,-0.05537130497476568,0.0005767844268204759
1372,"Marion County, WV",County or equivalent,56566,55962,-489,6449,6971,-522,190,-110,80,-0.0019446310504543363,0.0033589081780574905
1373,"Churchill County, NV",County or equivalent,24816,25363,488,3311,2825,486,441,-461,-20,-0.01857672469374597,0.017770793036750485
1374,"Rice County, MN",County or equivalent,64231,67084,2951,7495,5024,2471,1782,-1294,488,-0.02014603540346561,0.027743612897199173
1375,"St. Francois County, MO",County or equivalent,65534,66485,1116,7393,7951,-558,20,1668,1688,0.02545243690298166,0.00030518509475997187
1376,"Otter Tail County, MN",County or equivalent,57291,58741,1440,6595,6899,-304,433,1371,1804,0.02393046028171964,0.007557906128362221
1377,"Lyon County, NV",County or equivalent,52049,58319,6334,5938,6052,-114,-233,6670,6437,0.12814847547503316,-0.0044765509423812175
1378,"Hancock County, OH",County or equivalent,74698,75407,617,9234,7637,1597,1355,-2310,-955,-0.030924522744919542,0.01813970922916276
1379,"Ben Hill County, GA",County or equivalent,17649,16614,-1048,2336,2276,60,49,-1155,-1106,-0.0654428012918579,0.002776361266927305
1380,"Rutherford County, NC",County or equivalent,67739,67076,-743,6919,8775,-1856,57,1125,1182,0.016607862531185874,0.0008414650349134178
1381,"St. Francis County, AR",County or equivalent,28131,24682,-3564,3434,2964,470,240,-4309,-4069,-0.1531762112971455,0.008531513277167538
1382,"Webster County, IA",County or equivalent,37882,35934,-2077,4515,4574,-59,513,-2538,-2025,-0.06699751861042183,0.013542051634021435
1383,"Pulaski County, MO",County or equivalent,52865,52709,427,8086,3184,4902,2627,-7217,-4590,-0.13651754468930294,0.04969261326019105
1384,"Hancock County, IL",County or equivalent,19091,17422,-1682,1933,2119,-186,33,-1530,-1497,-0.08014247551202137,0.001728563197318108
1385,"Lee County, IA",County or equivalent,35850,33480,-2382,4047,4460,-413,44,-2007,-1963,-0.05598326359832636,0.0012273361227336122
1386,"Clark County, MO",County or equivalent,7139,6830,-302,789,841,-52,30,-283,-253,-0.0396414063594341,0.004202269225381706
1387,"Morgan County, CO",County or equivalent,28243,28941,782,4443,2683,1760,1175,-2165,-990,-0.0766561625889601,0.041603229118719685
1388,"DeKalb County, AL",County or equivalent,71133,71658,568,8600,8124,476,607,-475,132,-0.00667763204138726,0.008533310840256983
1389,"Vernon Parish, LA",County or equivalent,52737,47894,-4463,10086,4079,6007,1939,-12535,-10596,-0.23768890911504256,0.03676735498795912
1390,"Clinton County, IN",County or equivalent,33222,32206,-1013,4494,3717,777,64,-1868,-1804,-0.056227800854855216,0.0019264342905303716
1391,"Anderson County, KY",County or equivalent,21478,22833,1364,2606,2222,384,68,923,991,0.04297420616444734,0.003166030356644008
1392,"Franklin County, KY",County or equivalent,49248,51118,1856,5896,5519,377,687,833,1520,0.016914392462638074,0.01394980506822612
1393,"Gillespie County, TX",County or equivalent,24875,26960,2132,2544,3644,-1100,355,2881,3236,0.11581909547738692,0.014271356783919597
1394,"Stephenson County, IL",County or equivalent,47606,43831,-3873,5034,5614,-580,209,-3513,-3304,-0.07379321934209973,0.004390202915598874
1395,"Dodge County, NE",County or equivalent,36671,36222,-461,4914,4513,401,458,-1306,-848,-0.03561397289411252,0.012489433067001171
1396,"Sandusky County, OH",County or equivalent,60886,58351,-2595,6771,6719,52,126,-2772,-2646,-0.04552770751896988,0.002069441250862267
1397,"Cherokee County, SC",County or equivalent,55534,57316,1832,6885,6562,323,3,1547,1550,0.02785680844167537,5.4020960132531424e-05
1398,"Cooke County, TX",County or equivalent,38482,41393,2948,5515,4225,1290,315,1351,1666,0.03510732290421496,0.008185645236734058
1399,"Knox County, IL",County or equivalent,52911,49053,-3870,5670,6902,-1232,838,-3445,-2607,-0.06510933454291168,0.015837916501294628
1400,"McKinley County, NM",County or equivalent,71673,70824,-661,10844,6225,4619,630,-5930,-5300,-0.08273687441574931,0.008789920890711983
1401,"Finney County, KS",County or equivalent,36951,35917,-868,6901,2202,4699,1189,-6800,-5611,-0.1840274958729128,0.0321777489107196
1402,"Kearny County, KS",County or equivalent,4001,3745,-237,628,360,268,50,-560,-510,-0.13996500874781306,0.012496875781054736
1403,"Douglas County, NV",County or equivalent,47037,49088,2088,3386,5034,-1648,29,3742,3771,0.07955439334991603,0.0006165359185322192
1404,"Georgetown County, SC",County or equivalent,60343,63353,3029,5766,7792,-2026,155,4930,5085,0.08169961718840628,0.0025686492219478647
1405,"Campbell County, WY",County or equivalent,46253,46676,543,7210,2653,4557,30,-4122,-4092,-0.08911854366203273,0.0006486065768706895
1406,"Crook County, WY",County or equivalent,7119,7593,513,1047,649,398,75,43,118,0.006040174181767102,0.010535187526337971
1407,"Weston County, WY",County or equivalent,7198,6743,-465,737,716,21,117,-604,-487,-0.08391219783273131,0.016254515143095304
1408,"Barren County, KY",County or equivalent,42117,44300,2136,5664,5140,524,260,1374,1634,0.032623406225514635,0.006173279198423439
1409,"Metcalfe County, KY",County or equivalent,10135,10058,-47,1306,1340,-34,3,-13,-10,-0.0012826837691169216,0.00029600394671928964
1410,"Garfield County, CO",County or equivalent,56072,60366,3993,8215,3345,4870,301,-1202,-901,-0.021436724211727782,0.0053680981595092036
1411,"Pitkin County, CO",County or equivalent,17156,17894,749,1422,547,875,853,-981,-128,-0.05718116110981581,0.04972021450221497
1412,"Fulton County, NY",County or equivalent,55453,52812,-2697,5429,6218,-789,139,-2030,-1891,-0.03660757758822787,0.0025066272338737307
1413,"Hood County, TX",County or equivalent,51268,63527,12366,6041,6927,-886,350,12849,13199,0.2506241710228603,0.006826870562534134
1414,"Itasca County, MN",County or equivalent,45034,45268,213,4704,5344,-640,87,814,901,0.0180752320468979,0.0019318736954301195
1415,"Cibola County, NM",County or equivalent,27319,26354,-864,3647,2690,957,227,-2059,-1832,-0.07536879095135254,0.008309235330722208
1416,"Barton County, KS",County or equivalent,27675,25658,-2014,3504,3076,428,143,-2582,-2439,-0.09329719963866304,0.005167118337850046
1417,"Greene County, TN",County or equivalent,68834,69571,746,6607,9325,-2718,174,3342,3516,0.0485515878780835,0.002527820553796089
1418,"Decatur County, IN",County or equivalent,25795,26584,847,3416,2776,640,224,2,226,7.753440589261485e-05,0.008683853459972864
1419,"Washington County, MS",County or equivalent,51098,42837,-8298,7275,6123,1152,163,-9671,-9508,-0.18926376766213945,0.0031899487259775326
1420,"Darke County, OH",County or equivalent,52964,51205,-1763,6372,6170,202,125,-2079,-1954,-0.03925307756211766,0.002360093648515973
1421,"Carroll County, MS",County or equivalent,10606,9732,-869,909,1110,-201,-6,-654,-660,-0.061663209504054316,-0.0005657175183858194
1422,"Leflore County, MS",County or equivalent,32420,27854,-4528,4770,3771,999,107,-5714,-5607,-0.17624922887106725,0.0033004318322023447
1423,"Greenwood County, SC",County or equivalent,69759,71074,1391,8745,7785,960,907,-442,465,-0.006336100001433507,0.01300190656402758
1424,"Grenada County, MS",County or equivalent,21837,20610,-1293,2755,3044,-289,-26,-966,-992,-0.04423684572056601,-0.0011906397398910107
1425,"Texas County, OK",County or equivalent,20800,19997,-643,3765,1673,2092,1139,-3914,-2775,-0.1881730769230769,0.05475961538461538
1426,"Blaine County, ID",County or equivalent,21296,23426,2049,2172,1112,1060,1073,-85,988,-0.003991359879789632,0.050385048835462055
1427,"Camas County, ID",County or equivalent,1115,1130,13,96,79,17,-5,-4,-9,-0.003587443946188341,-0.004484304932735426
1428,"Marion County, MO",County or equivalent,28785,28423,-355,3746,3389,357,151,-837,-686,-0.02907764460656592,0.005245787736668403
1429,"Ralls County, MO",County or equivalent,10196,10299,121,1003,978,25,0,99,99,0.009709690074539036,0.0
1430,"Boone County, AR",County or equivalent,36893,37625,707,4468,4571,-103,-8,846,838,0.022931179356517496,-0.00021684330360773047
1431,"Newton County, AR",County or equivalent,8305,7602,-713,760,1012,-252,0,-461,-461,-0.055508729680915116,0.0
1432,"Adams County, NE",County or equivalent,31328,31321,-46,4138,3208,930,478,-1441,-963,-0.04599719101123596,0.015257916241062309
1433,"Ellis County, KS",County or equivalent,28424,28671,219,3562,2567,995,627,-1412,-785,-0.04967632986208838,0.02205882352941177
1434,"Summit County, UT",County or equivalent,36502,42499,6175,4351,1509,2842,978,2363,3341,0.06473617883951564,0.026793052435482988
1435,"Wasatch County, UT",County or equivalent,23642,35300,11775,4308,1361,2947,626,8116,8742,0.3432873699348617,0.026478301328144827
1436,"Jefferson County, MT",County or equivalent,11406,12360,957,892,1102,-210,52,1125,1177,0.09863229879011047,0.0045590040329651065
1437,"Lewis and Clark County, MT",County or equivalent,63578,70229,6835,7772,6151,1621,363,4861,5224,0.07645726509169838,0.005709522161754066
1438,"Phillips County, AR",County or equivalent,21675,17299,-4456,2989,2744,245,-14,-4741,-4755,-0.21873125720876585,-0.0006459054209919262
1439,"Vance County, NC",County or equivalent,45293,44718,-694,5795,5283,512,474,-1684,-1210,-0.03718013821120261,0.010465193296977458
1440,"Deaf Smith County, TX",County or equivalent,19465,18277,-1095,3438,1527,1911,173,-3210,-3037,-0.16491137939892114,0.008887747238633444
1441,"Morrow County, OR",County or equivalent,11207,11700,525,1660,823,837,192,-515,-323,-0.0459534219684126,0.017132149549388773
1442,"Umatilla County, OR",County or equivalent,76093,77752,1865,10503,6702,3801,44,-1959,-1915,-0.025744812269196903,0.0005782397855256067
1443,"Hillsdale County, MI",County or equivalent,46646,45658,-1033,5448,4952,496,55,-1572,-1517,-0.03370063885434978,0.0011790935985936631
1444,"Hawaii County, HI",County or equivalent,185361,203340,18264,23915,17545,6370,5650,6312,11962,0.03405247058442715,0.030481061280420368
1445,"Lea County, NM",County or equivalent,64598,71830,7104,11435,5556,5879,1309,-163,1146,-0.0025232979349205857,0.02026378525650949
1446,"Allegan County, MI",County or equivalent,111521,118927,7529,14015,9922,4093,625,2870,3495,0.02573506335129707,0.005604325642704065
1447,"Hood River County, OR",County or equivalent,22447,23280,934,2795,1839,956,25,-38,-13,-0.0016928765536597318,0.0011137345747761393
1448,"Hempstead County, AR",County or equivalent,22604,21253,-1340,3216,2508,708,-67,-1986,-2053,-0.08786055565386658,-0.002964077154485932
1449,"Nevada County, AR",County or equivalent,8994,8099,-916,1037,1201,-164,-20,-733,-753,-0.08149877696241939,-0.0022237046920169003
1450,"Houghton County, MI",County or equivalent,36729,35126,-1498,3804,3643,161,1388,-3065,-1677,-0.08344904571319665,0.03779030194124534
1451,"Keweenaw County, MI",County or equivalent,2170,2119,-38,170,238,-68,5,27,32,0.012442396313364057,0.002304147465437788
1452,"Columbia County, NY",County or equivalent,63035,59534,-3529,5249,6954,-1705,592,-2378,-1786,-0.037725073371936216,0.009391607836916002
1453,"Huntingdon County, PA",County or equivalent,45999,44590,-1412,4142,4894,-752,306,-931,-625,-0.020239570425444036,0.0066523185286636675
1454,"Huntington County, IN",County or equivalent,37115,36395,-728,4331,4205,126,154,-1002,-848,-0.02699717095513943,0.004149265795500471
1455,"Walker County, TX",County or equivalent,68239,72164,4302,6323,5475,848,1539,1874,3413,0.02746230161637773,0.0225530854789783
1456,"Beadle County, SD",County or equivalent,17406,18513,1114,3177,1989,1188,1682,-1766,-84,-0.10145926691945306,0.09663334482362404
1457,"Jerauld County, SD",County or equivalent,2091,1985,-86,237,280,-43,34,-77,-43,-0.03682448589191775,0.016260162601626018
1458,"Reno County, KS",County or equivalent,64552,61793,-2718,7189,7634,-445,297,-2538,-2241,-0.03931713967034329,0.004600941876316768
1459,"McLeod County, MN",County or equivalent,36592,35710,-935,4195,3474,721,111,-1779,-1668,-0.048617184083952776,0.003033449934411893
1460,"Indiana County, PA",County or equivalent,88864,83664,-5217,8407,9395,-988,752,-4980,-4228,-0.056040691393590206,0.008462369463449766
1461,"Sunflower County, MS",County or equivalent,28983,24740,-4643,3242,3147,95,50,-4872,-4822,-0.1680985405237553,0.001725149225407998
1462,"Dickinson County, MI",County or equivalent,26156,25112,-1056,2549,3169,-620,48,-471,-423,-0.0180073405719529,0.0018351429882244989
1463,"Florence County, WI",County or equivalent,4398,4298,-125,290,581,-291,-2,170,168,0.03865393360618463,-0.00045475216007276033
1464,"Jackson County, OH",County or equivalent,33249,32493,-726,4244,4258,-14,170,-877,-707,-0.026376733134831118,0.005112935727390297
1465,"Teton County, ID",County or equivalent,10149,12501,2336,1498,446,1052,262,1005,1267,0.09902453443689034,0.025815351266134597
1466,"Teton County, WY",County or equivalent,21298,23497,2199,2522,887,1635,400,135,535,0.006338623344915016,0.0187811062071556
1467,"Morgan County, IL",County or equivalent,35499,33400,-2142,3686,4046,-360,401,-2169,-1768,-0.061100312684864364,0.011296092847685851
1468,"Scott County, IL",County or equivalent,5330,4950,-408,473,603,-130,31,-310,-279,-0.058161350844277676,0.005816135084427768
1469,"Cherokee County, TX",County or equivalent,50932,52875,2048,7618,5506,2112,140,-165,-25,-0.0032396136024503263,0.0027487630566245193
1470,"Stutsman County, ND",County or equivalent,21138,20498,-602,2367,2464,-97,187,-679,-492,-0.03212224429936607,0.00884662692780774
1471,"Chautauqua County, NY",County or equivalent,134726,126032,-8875,13986,15082,-1096,1650,-9477,-7827,-0.07034276976975491,0.012247079257158974
1472,"Walker County, AL",County or equivalent,66995,63143,-3876,8097,10271,-2174,163,-1821,-1658,-0.02718113292036719,0.002433017389357415
1473,"Dubois County, IN",County or equivalent,41905,42542,656,5497,4182,1315,536,-1181,-645,-0.028182794415940817,0.012790836415702184
1474,"Pike County, IN",County or equivalent,12716,12378,-317,1459,1485,-26,37,-324,-287,-0.02547971060081787,0.002909720037747719
1475,"Jackson County, GA",County or equivalent,60706,76199,15729,8387,5889,2498,282,12936,13218,0.21309261028563894,0.0046453398346127245
1476,"Jefferson Davis Parish, LA",County or equivalent,31629,31208,-381,4354,3882,472,77,-917,-840,-0.028992380410382875,0.0024344746909481805
1477,"Wayne County, GA",County or equivalent,30080,30023,-79,3979,3463,516,158,-776,-618,-0.02579787234042553,0.005252659574468085
1478,"Juneau City and Borough, AK",County or equivalent,31387,31849,573,3772,1917,1855,698,-1985,-1287,-0.063242743811132,0.02223850638799503
1479,"Flathead County, MT",County or equivalent,90863,105851,14929,11423,8967,2456,359,12082,12441,0.1329694154936553,0.003951003158601411
1480,"Kauai County, HI",County or equivalent,67208,71851,4756,8626,6054,2572,2756,-519,2237,-0.007722294964885133,0.041007022973455536
1481,"Buffalo County, NE",County or equivalent,46176,50114,4015,6945,3645,3300,832,-108,724,-0.002338877338877339,0.018018018018018014
1482,"Kearney County, NE",County or equivalent,6476,6652,163,825,747,78,70,17,87,0.002625077208153181,0.010809141445336628
1483,"Cheshire County, NH",County or equivalent,77063,76228,-895,6878,7398,-520,726,-1067,-341,-0.013845814463490909,0.009420863449385568
1484,"Noble County, IN",County or equivalent,47455,47832,294,6270,4630,1640,128,-1461,-1333,-0.03078706142661469,0.002697292171530924
1485,"Dunklin County, MO",County or equivalent,31951,28878,-3081,4338,4502,-164,267,-3200,-2933,-0.10015335983224312,0.008356545961002786
1486,"Kerr County, TX",County or equivalent,49640,52869,3226,5294,7469,-2175,363,5038,5401,0.10149073327961322,0.007312651087832394
1487,"Ketchikan Gateway Borough, AK",County or equivalent,13584,13747,213,1668,977,691,414,-894,-480,-0.06581272084805652,0.030477031802120143
1488,"Monroe County, FL",County or equivalent,73226,73900,810,7368,7228,140,3537,-2886,651,-0.0394122306284653,0.04830251549995903
1489,"Dare County, NC",County or equivalent,33981,37547,3627,3525,3356,169,361,3094,3455,0.09105088137488596,0.01062358376739943
1490,"Kenedy County, TX",County or equivalent,417,379,-34,36,28,8,48,-94,-46,-0.2254196642685851,0.11510791366906475
1491,"Kleberg County, TX",County or equivalent,32037,30338,-1723,4547,2657,1890,845,-4503,-3658,-0.14055623185691546,0.02637575303555264
1492,"Lenoir County, NC",County or equivalent,59491,55720,-3791,6631,7408,-777,274,-3283,-3009,-0.05518481787161083,0.0046057386831621595
1493,"Adair County, MO",County or equivalent,25638,25399,-218,2740,2257,483,1027,-1733,-706,-0.06759497620719243,0.04005772681176379
1494,"Schuyler County, MO",County or equivalent,4441,4534,103,674,531,143,11,-50,-39,-0.01125872551227201,0.0024769196126998424
1495,"Klamath County, OR",County or equivalent,66323,68739,2356,8128,8029,99,90,2194,2284,0.03308053013283476,0.0013569953108273148
1496,"Belknap County, NH",County or equivalent,60101,61551,1476,5291,7132,-1841,580,2790,3370,0.0464218565414885,0.009650421789986856
1497,"Union County, OR",County or equivalent,25725,26551,814,3002,2831,171,230,424,654,0.016482021379980564,0.008940719144800777
1498,"Chambers County, AL",County or equivalent,34105,32865,-1289,3934,4664,-730,234,-776,-542,-0.02275326198504618,0.006861164052191761
1499,"Troup County, GA",County or equivalent,67060,70214,3172,9278,7145,2133,941,136,1077,0.0020280345958842826,0.01403220996122875
1500,"Columbia County, FL",County or equivalent,67558,72654,5128,8215,8219,-4,395,4744,5139,0.07022114331389323,0.005846827910832174
1501,"Dawson County, TX",County or equivalent,13826,12974,-859,1919,1401,518,149,-1571,-1422,-0.11362650079560248,0.01077679733834804
1502,"Albany County, WY",County or equivalent,36471,38950,2651,3993,1963,2030,1535,-929,606,-0.025472293054755832,0.04208823448767514
1503,"Mora County, NM",County or equivalent,4893,4478,-403,420,466,-46,-5,-355,-360,-0.07255262620069487,-0.0010218679746576743
1504,"San Miguel County, NM",County or equivalent,29392,27144,-2231,2982,2901,81,667,-3010,-2343,-0.10240881872618401,0.022693249863908548
1505,"Jasper County, MS",County or equivalent,17013,16332,-735,2180,2028,152,-6,-886,-892,-0.05207782284135661,-0.00035267148651031563
1506,"Jones County, MS",County or equivalent,67819,67993,215,9789,7801,1988,149,-1895,-1746,-0.02794202214718589,0.002197024432681107
1507,"Scotland County, NC",County or equivalent,36062,34637,-1523,4623,4139,484,167,-2183,-2016,-0.06053463479562975,0.004630913426875936
1508,"Lawrence County, TN",County or equivalent,41971,44432,2573,5815,5494,321,44,2223,2267,0.052965142598460836,0.001048342903433323
1509,"Laclede County, MO",County or equivalent,35697,35895,301,4883,4185,698,30,-425,-395,-0.011905762388996276,0.0008404067568703253
1510,"Grafton County, NH",County or equivalent,89133,90691,1556,7490,8466,-976,3035,-446,2589,-0.005003758428415963,0.03405023952969158
1511,"Sullivan County, NH",County or equivalent,43744,43267,-471,4041,4554,-513,192,-121,71,-0.0027660936356986104,0.0043891733723482075
1512,"Orange County, VT",County or equivalent,28945,28837,-101,2704,2736,-32,88,-131,-43,-0.0045258248402142,0.003040248747624805
1513,"Windsor County, VT",County or equivalent,56604,54988,-1670,4837,6049,-1212,532,-954,-422,-0.016853932584269662,0.009398629072150378
1514,"Hockley County, TX",County or equivalent,22827,22921,23,3240,2199,1041,131,-1146,-1015,-0.05020370613746879,0.005738818066324966
1515,"Union County, PA",County or equivalent,45005,44294,-674,4122,3937,185,466,-1340,-874,-0.02977446950338852,0.010354405066103769
1516,"Marshall County, TN",County or equivalent,30688,35016,4405,3943,3425,518,371,3532,3903,0.11509384775808132,0.01208941605839416
1517,"Mifflin County, PA",County or equivalent,46638,46064,-613,5965,5582,383,106,-1065,-959,-0.022835456065869036,0.002272824735194477
1518,"Dawson County, NE",County or equivalent,24302,23510,-806,4047,2165,1882,1018,-3736,-2718,-0.1537322031108551,0.041889556415109865
1519,"Gosper County, NE",County or equivalent,2040,1986,-58,224,243,-19,0,-38,-38,-0.01862745098039216,0.0
1520,"Seward County, KS",County or equivalent,22972,21038,-1912,4355,1325,3030,955,-5929,-4974,-0.2580968135121017,0.041572348946543616
1521,"Logan County, IL",County or equivalent,30282,28383,-1922,3067,3425,-358,141,-1715,-1574,-0.056634304207119734,0.004656231424608678
1522,"Clinton County, PA",County or equivalent,39262,37957,-1291,4319,4171,148,125,-1557,-1432,-0.0396566654780704,0.0031837400030563907
1523,"Cass County, IN",County or equivalent,38985,37388,-1582,4822,4140,682,881,-3164,-2283,-0.08115942028985508,0.022598435295626523
1524,"Clay County, KY",County or equivalent,21668,19631,-2105,2736,2748,-12,46,-2161,-2115,-0.0997323241646668,0.0021229462802289088
1525,"Knox County, KY",County or equivalent,31846,31022,-860,4124,4141,-17,101,-936,-835,-0.029391446335489544,0.0031715129058594487
1526,"Laurel County, KY",County or equivalent,58993,61238,2393,7534,6341,1193,99,1151,1250,0.019510789415693387,0.0016781652060413948
1527,"Whitley County, KY",County or equivalent,35718,36451,817,5615,4952,663,180,-16,164,-0.00044795341284506414,0.005039475894506971
1528,"Los Alamos County, NM",County or equivalent,17995,19462,1512,1744,1267,477,766,241,1007,0.013392609058071686,0.04256737982772992
1529,"Mason County, MI",County or equivalent,28719,29164,475,2931,3464,-533,120,913,1033,0.03179080051533828,0.004178418468609631
1530,"Angelina County, TX",County or equivalent,86905,86796,25,12042,9224,2818,168,-2915,-2747,-0.03354237385650998,0.0019331453886427708
1531,"Robeson County, NC",County or equivalent,134469,129999,-4206,18581,13843,4738,522,-9437,-8915,-0.07017974403022258,0.003881935613412757
1532,"McDonough County, IL",County or equivalent,32631,29295,-3321,2875,3154,-279,815,-3891,-3076,-0.11924243817229015,0.02497624957862156
1533,"Jefferson County, IN",County or equivalent,32399,32110,-290,3748,3864,-116,158,-312,-154,-0.009629926849594123,0.004876693725114973
1534,"Hopkins County, KY",County or equivalent,46841,44662,-2255,5507,6135,-628,226,-1837,-1611,-0.03921777929591597,0.004824832945496467
1535,"Columbia County, AR",County or equivalent,24722,23331,-1221,2981,3117,-136,235,-1349,-1114,-0.054566782622765146,0.009505703422053232
1536,"Franklin County, NY",County or equivalent,51642,49965,-1632,5020,4778,242,204,-2108,-1904,-0.04081948801363231,0.00395027303357732
1537,"Hot Spring County, AR",County or equivalent,33236,33787,771,3658,4095,-437,79,1109,1188,0.03336743290407991,0.0023769406667469013
1538,"Manitowoc County, WI",County or equivalent,81330,78757,-2687,8197,8846,-649,464,-2492,-2028,-0.030640600024591173,0.005705151850485675
1539,"Washington County, OH",County or equivalent,61714,59652,-2135,6216,7590,-1374,283,-995,-712,-0.016122759827591794,0.004585669378098973
1540,"Menominee County, MI",County or equivalent,23968,22608,-1421,2041,2828,-787,27,-644,-617,-0.026869158878504672,0.001126502002670227
1541,"Marinette County, WI",County or equivalent,41662,40262,-1487,3837,5310,-1473,87,-66,21,-0.0015841774278719215,0.002088233882194806
1542,"Grant County, IN",County or equivalent,69906,65225,-4838,7837,8508,-671,246,-4416,-4170,-0.0631705433010042,0.003519011243670072
1543,"McDowell County, NC",County or equivalent,45102,45782,780,4624,5281,-657,168,1313,1481,0.02911179105139462,0.0037248902487694562
1544,"Marion County, OH",County or equivalent,66459,64820,-1685,7746,7587,159,342,-2166,-1824,-0.032591522592876815,0.0051460298830858136
1545,"Marquette County, MI",County or equivalent,67080,65834,-1237,6347,6924,-577,409,-1034,-625,-0.0154144305307096,0.006097197376267144
1546,"Lyon County, MN",County or equivalent,25852,25271,-587,3710,2256,1454,1011,-3080,-2069,-0.11913971839702925,0.039107225746557325
1547,"Saline County, MO",County or equivalent,23422,22858,-514,2841,2606,235,489,-1233,-744,-0.05264281444795491,0.02087780718982153
1548,"Marshall County, IA",County or equivalent,40722,39495,-1153,5444,4905,539,1255,-2955,-1700,-0.07256519817297775,0.03081872206669613
1549,"Weakley County, TN",County or equivalent,35044,33334,-1681,3498,3914,-416,272,-1549,-1277,-0.04420157516265266,0.00776167104211848
1550,"Henry County, VA",County or equivalent,54102,50309,-3835,4945,7158,-2213,160,-1752,-1592,-0.0323832760341577,0.002957376806772393
1551,"Martinsville city, VA",County or equivalent,13786,12355,-1485,1792,2761,-969,131,-645,-514,-0.04678659509647468,0.009502393732772377
1552,"Nodaway County, MO",County or equivalent,23402,21743,-1630,2271,1976,295,157,-2097,-1940,-0.08960772583539868,0.006708828305273053
1553,"Cerro Gordo County, IA",County or equivalent,44097,42103,-2048,4797,5237,-440,307,-1899,-1592,-0.04306415402408327,0.006961924847495296
1554,"Worth County, IA",County or equivalent,7582,7359,-232,801,853,-52,9,-188,-179,-0.024795568451595886,0.0011870218939593776
1555,"Graves County, KY",County or equivalent,37254,36818,-324,5129,4661,468,413,-1186,-773,-0.0318355075964997,0.01108605787298008
1556,"Mason County, KY",County or equivalent,17503,17035,-453,2149,2221,-72,114,-495,-381,-0.02828086613723362,0.006513169170999257
1557,"Pittsburg County, OK",County or equivalent,45799,43679,-2148,5390,6292,-902,86,-1305,-1219,-0.02849407192296775,0.001877770256992511
1558,"Pike County, MS",County or equivalent,40442,38997,-1405,5622,5241,381,49,-1826,-1777,-0.04515108055981405,0.0012116116908164778
1559,"Warren County, TN",County or equivalent,39859,41605,1781,4934,5034,-100,310,1603,1913,0.040216764093429336,0.007777415389247096
1560,"McPherson County, KS",County or equivalent,29128,28448,-738,3301,3799,-498,118,-358,-240,-0.012290579511123318,0.004051084866794836
1561,"Crawford County, PA",County or equivalent,88614,83697,-5053,9510,10355,-845,192,-4366,-4174,-0.049269867063895086,0.002166700521362313
1562,"Dunn County, WI",County or equivalent,43888,45452,1587,4547,3403,1144,469,-12,457,-0.0002734232592052497,0.010686292380605178
1563,"Clarke County, MS",County or equivalent,16723,15299,-1425,1946,2153,-207,3,-1220,-1217,-0.0729534174490223,0.00017939364946480894
1564,"Kemper County, MS",County or equivalent,10454,9521,-917,902,1042,-140,-3,-779,-782,-0.07451693131815572,-0.00028697149416491294
1565,"Lauderdale County, MS",County or equivalent,80395,73751,-6529,10192,8920,1272,403,-8236,-7833,-0.10244418185210524,0.005012749549101313
1566,"Audrain County, MO",County or equivalent,25453,24835,-696,3444,3092,352,28,-1067,-1039,-0.041920402310140256,0.0011000667897693786
1567,"Ottawa County, OK",County or equivalent,31860,30879,-969,4453,4660,-207,168,-924,-756,-0.029001883239171376,0.005273069679849341
1568,"Bell County, KY",County or equivalent,28704,25482,-3206,3492,4022,-530,25,-2708,-2683,-0.0943422519509476,0.000870958751393534
1569,"Baldwin County, GA",County or equivalent,45703,45099,-741,4560,4499,61,349,-1228,-879,-0.026869133317287703,0.0076362602017373046
1570,"Hancock County, GA",County or equivalent,9433,8494,-907,701,1030,-329,59,-671,-612,-0.07113325559207039,0.0062546379730732534
1571,"Webster Parish, LA",County or equivalent,41202,37943,-3263,5006,5451,-445,60,-2880,-2820,-0.06989951944080385,0.0014562399883500802
1572,"Palo Pinto County, TX",County or equivalent,28093,29320,1186,3654,3425,229,108,857,965,0.03050581995514897,0.003844374043355996
1573,"McHenry County, ND",County or equivalent,5402,5695,303,695,626,69,11,210,221,0.03887449092928545,0.0020362828582006663
1574,"Renville County, ND",County or equivalent,2484,2283,-187,288,287,1,4,-196,-192,-0.07890499194847021,0.0016103059581320449
1575,"Ward County, ND",County or equivalent,62128,68466,6791,11808,4982,6826,2402,-2624,-222,-0.04223538501158898,0.038662116919907286
1576,"Davison County, SD",County or equivalent,19484,19812,308,2616,2203,413,259,-356,-97,-0.018271402176144532,0.013292958324779306
1577,"Hanson County, SD",County or equivalent,3331,3489,157,455,222,233,-2,-74,-76,-0.02221555088561994,-0.0006004202942059443
1578,"Randolph County, MO",County or equivalent,25454,24409,-1006,2939,2851,88,46,-1140,-1094,-0.04478667400015714,0.0018071815824624812
1579,"Montrose County, CO",County or equivalent,41182,43322,2050,4540,4420,120,31,1910,1941,0.04637948618328396,0.0007527560584721482
1580,"Ouray County, CO",County or equivalent,4457,5001,559,295,295,0,8,543,551,0.12183082791115099,0.0017949293246578414
1581,"Carteret County, NC",County or equivalent,66700,69558,3095,5919,8271,-2352,621,4836,5457,0.07250374812593703,0.009310344827586206
1582,"St. Mary Parish, LA",County or equivalent,54553,48330,-6317,7372,5767,1605,542,-8526,-7984,-0.15628838010741847,0.009935292284567302
1583,"Latah County, ID",County or equivalent,37258,40830,3587,4455,2293,2162,1542,-106,1436,-0.0028450265714745826,0.04138708465296044
1584,"Grant County, WA",County or equivalent,89554,99377,10253,15508,7078,8430,1757,107,1864,0.0011948098354065705,0.01961944748419948
1585,"Colquitt County, GA",County or equivalent,45638,45542,46,6717,4900,1817,159,-1916,-1757,-0.041982558394320524,0.0034839388229107324
1586,"Baxter County, AR",County or equivalent,41511,42242,731,3590,6984,-3394,31,4117,4148,0.09917853099178532,0.0007467900074679001
1587,"Elmore County, ID",County or equivalent,27125,27448,408,4687,1926,2761,1170,-3579,-2409,-0.13194470046082948,0.043133640552995386
1588,"Surry County, NC",County or equivalent,73779,71683,-2069,7759,9277,-1518,309,-817,-508,-0.011073611732335759,0.004188183629488066
1589,"Logan County, WV",County or equivalent,36719,31688,-5062,3925,5553,-1628,-6,-3449,-3455,-0.09392957324545877,-0.00016340314278711295
1590,"Isabella County, MI",County or equivalent,70297,69504,-809,6668,4954,1714,1727,-4299,-2572,-0.06115481457245686,0.02456719347909584
1591,"Camp County, TX",County or equivalent,12396,13060,661,1887,1478,409,369,-114,255,-0.009196515004840271,0.029767666989351405
1592,"Titus County, TX",County or equivalent,32417,32926,592,5012,2822,2190,380,-1984,-1604,-0.061202455501742914,0.011722244501341888
1593,"Bath County, KY",County or equivalent,11622,12481,889,1756,1488,268,19,607,626,0.05222853209430391,0.0016348304938908966
1594,"Menifee County, KY",County or equivalent,6368,6502,196,710,807,-97,-3,292,289,0.04585427135678392,-0.00047110552763819093
1595,"Montgomery County, KY",County or equivalent,26554,28186,1675,3829,2954,875,-22,835,813,0.03144535663176923,-0.0008285004142502071
1596,"Jefferson County, IL",County or equivalent,38757,37235,-1590,4822,4641,181,271,-2023,-1752,-0.05219702247335965,0.006992285264597363
1597,"Knox County, OH",County or equivalent,61087,62423,1497,7523,6335,1188,102,231,333,0.003781491970468349,0.0016697497012457645
1598,"Calloway County, KY",County or equivalent,37360,39300,2101,3869,4091,-222,1247,1072,2319,0.02869379014989293,0.0333779443254818
1599,"Muscatine County, IA",County or equivalent,42804,42394,-409,5515,4102,1413,761,-2579,-1818,-0.060251378375852725,0.017778712269881317
1600,"Muskogee County, OK",County or equivalent,71121,67610,-3381,9190,9485,-295,279,-3353,-3074,-0.04714500639754784,0.003922891972835027
1601,"Nacogdoches County, TX",County or equivalent,64684,64753,229,8761,5903,2858,352,-3006,-2654,-0.04647207964875394,0.005441840331457547
1602,"Concordia Parish, LA",County or equivalent,20840,18914,-1908,2676,2524,152,-23,-2040,-2063,-0.09788867562380038,-0.0011036468330134358
1603,"Adams County, MS",County or equivalent,32581,30275,-2029,3763,4244,-481,1545,-3133,-1588,-0.09616033884779472,0.047420275620760566
1604,"Natchitoches Parish, LA",County or equivalent,39523,37655,-1908,5203,4109,1094,203,-3188,-2985,-0.0806618930749184,0.005136249778609923
1605,"Newberry County, SC",County or equivalent,37611,38445,935,4448,4478,-30,95,895,990,0.02379622982638058,0.0025258567972135807
1606,"Henry County, IN",County or equivalent,49530,48033,-1433,4871,5967,-1096,39,-345,-306,-0.006965475469412477,0.0007874015748031496
1607,"Lawrence County, PA",County or equivalent,91016,85083,-6073,9058,11829,-2771,284,-3555,-3271,-0.0390590665377516,0.003120330491342181
1608,"Tuscarawas County, OH",County or equivalent,92545,91776,-809,11677,10771,906,781,-2443,-1662,-0.0263979685558377,0.008439137716786428
1609,"Lincoln County, OR",County or equivalent,45997,50583,4550,4289,6150,-1861,182,6197,6379,0.13472617779420398,0.0039567797899863035
1610,"Cocke County, TN",County or equivalent,35641,36225,583,3852,5225,-1373,21,1963,1984,0.05507701804102017,0.0005892090569849331
1611,"Brown County, MN",County or equivalent,25844,24846,-1047,2778,3052,-274,89,-856,-767,-0.033121807769695095,0.003443739359232317
1612,"Santa Cruz County, AZ",County or equivalent,47402,46808,-609,6591,3036,3555,1081,-5323,-4242,-0.11229483988017384,0.02280494493903211
1613,"Madison County, NE",County or equivalent,34963,34813,-63,5295,3710,1585,691,-2332,-1641,-0.0666990818865658,0.01976375025026457
1614,"Pierce County, NE",County or equivalent,7259,7184,-82,881,721,160,12,-252,-240,-0.03471552555448409,0.0016531202644992425
1615,"Stanton County, NE",County or equivalent,6141,5880,-248,765,449,316,40,-608,-568,-0.09900667643706236,0.006513597134017261
1616,"Lincoln County, NE",County or equivalent,36250,34347,-1941,4345,3776,569,222,-2733,-2511,-0.07539310344827586,0.006124137931034483
1617,"Logan County, NE",County or equivalent,772,747,-16,97,59,38,18,-74,-56,-0.09585492227979274,0.023316062176165803
1618,"McPherson County, NE",County or equivalent,539,474,-65,29,39,-10,0,-57,-57,-0.10575139146567718,0.0
1619,"Jennings County, IN",County or equivalent,28482,27515,-1014,3406,3055,351,39,-1404,-1365,-0.04929429113124079,0.0013692858647566884
1620,"Wilkes County, NC",County or equivalent,69265,68043,-1268,6970,8268,-1298,305,-208,97,-0.0030029596477297326,0.004403378329603696
1621,"Huron County, OH",County or equivalent,59566,57979,-1646,7449,6132,1317,187,-3167,-2980,-0.053167914582144184,0.0031393748111338683
1622,"Island County, WA",County or equivalent,78700,86014,7506,9310,7357,1953,1745,3794,5539,0.04820838627700127,0.0221728081321474
1623,"St. Lawrence County, NY",County or equivalent,111821,107185,-4756,11807,10413,1394,1380,-7559,-6179,-0.06759910929074145,0.012341152377460406
1624,"Venango County, PA",County or equivalent,54972,50328,-4660,5326,6727,-1401,42,-3288,-3246,-0.059812268063741535,0.0007640253219820999
1625,"Okeechobee County, FL",County or equivalent,40014,42297,2310,5430,4519,911,693,716,1409,0.017893737191982804,0.01731893837156995
1626,"Cattaraugus County, NY",County or equivalent,80220,75863,-4474,9107,8675,432,273,-5193,-4920,-0.06473448017950635,0.0034031413612565444
1627,"Otsego County, NY",County or equivalent,62260,58701,-3577,5276,6308,-1032,404,-2936,-2532,-0.047157083199486034,0.006488917442981047
1628,"Payette County, ID",County or equivalent,22640,24771,2149,3127,2206,921,-196,1440,1244,0.0636042402826855,-0.008657243816254417
1629,"Malheur County, OR",County or equivalent,31349,30983,-333,4304,3059,1245,-39,-1551,-1590,-0.0494752623688156,-0.0012440588216530036
1630,"St. Landry Parish, LA",County or equivalent,83503,81440,-1960,12844,10028,2816,90,-4816,-4726,-0.05767457456618325,0.001077805587823192
1631,"Orangeburg County, SC",County or equivalent,92323,85343,-7165,10609,11007,-398,333,-7113,-6780,-0.07704472341670006,0.0036069018554423064
1632,"Mahaska County, IA",County or equivalent,22409,22370,-14,2838,2384,454,303,-760,-457,-0.03391494488821456,0.01352135302780133
1633,"Adams County, WA",County or equivalent,18791,20027,1296,4031,1230,2801,271,-1788,-1517,-0.09515193443669842,0.01442179766909691
1634,"Bureau County, IL",County or equivalent,34959,32303,-2677,3424,3982,-558,158,-2287,-2129,-0.06541949140421636,0.004519580079521726
1635,"LaSalle County, IL",County or equivalent,113812,107571,-6340,12054,13376,-1322,347,-5344,-4997,-0.046954626928619125,0.0030488876392647524
1636,"Putnam County, IL",County or equivalent,6014,5716,-292,494,586,-92,8,-207,-199,-0.034419687396075815,0.0013302294645826404
1637,"Franklin County, KS",County or equivalent,25986,25703,-291,3194,2677,517,146,-952,-806,-0.03663511121373047,0.005618409913030093
1638,"Wapello County, IA",County or equivalent,35679,34985,-637,4495,4212,283,1230,-2131,-901,-0.05972701028616272,0.03447406037164718
1639,"Steele County, MN",County or equivalent,36497,36596,15,4577,3161,1416,71,-1479,-1408,-0.04052387867495959,0.0019453653724963696
1640,"Lafayette County, MS",County or equivalent,47574,54408,7047,5575,3908,1667,551,4678,5229,0.09833102114600413,0.011581956530878209
1641,"Dale County, AL",County or equivalent,50396,48959,-1294,6790,5262,1528,812,-3640,-2828,-0.07222795459957139,0.01611238987221208
1642,"Massac County, IL",County or equivalent,15380,13636,-1793,1602,2147,-545,9,-1260,-1251,-0.08192457737321196,0.0005851755526657997
1643,"Ballard County, KY",County or equivalent,8250,7769,-468,824,1077,-253,7,-219,-212,-0.026545454545454542,0.0008484848484848485
1644,"Livingston County, KY",County or equivalent,9520,9041,-478,994,1325,-331,11,-154,-143,-0.016176470588235296,0.0011554621848739494
1645,"McCracken County, KY",County or equivalent,65523,65644,97,7921,8280,-359,87,430,517,0.006562581078399951,0.0013277780321413856
1646,"Nye County, NV",County or equivalent,43848,48054,4110,3882,7389,-3507,-190,7810,7620,0.17811530742565224,-0.004333150884875022
1647,"Putnam County, FL",County or equivalent,74223,74815,435,8544,10141,-1597,139,1939,2078,0.02612397774274821,0.0018727348665508
1648,"Anderson County, TX",County or equivalent,58498,57805,-652,6125,6814,-689,409,-346,63,-0.005914732127594106,0.006991692023658929
1649,"Gray County, TX",County or equivalent,22474,21658,-879,3115,2671,444,57,-1408,-1351,-0.06265017353386135,0.0025362641274361483
1650,"Roberts County, TX",County or equivalent,920,813,-112,93,97,-4,0,-109,-109,-0.1184782608695652,0.0
1651,"Greene County, AR",County or equivalent,42202,45597,3507,5773,4984,789,46,2670,2716,0.06326714373726364,0.0010899957347992985
1652,"Henry County, TN",County or equivalent,32396,32056,-293,3363,4791,-1428,36,1126,1162,0.034757377454006665,0.0011112483022595384
1653,"Lamar County, TX",County or equivalent,49822,49905,114,6699,6414,285,101,-257,-156,-0.00515836377503914,0.002027216892136004
1654,"Labette County, KS",County or equivalent,21536,19586,-2023,2743,2698,45,34,-2115,-2081,-0.09820765230312037,0.0015787518573551265
1655,"Gila County, AZ",County or equivalent,53565,54303,711,5917,7887,-1970,257,2467,2724,0.04605619340987585,0.004797909082423224
1656,"Frio County, TX",County or equivalent,17255,20379,3162,2584,1412,1172,1895,78,1973,0.004520428861199652,0.10982323964068386
1657,"Loving County, TX",County or equivalent,84,181,99,15,14,1,0,96,96,1.1428571428571428,0.0
1658,"Reeves County, TX",County or equivalent,13830,15949,2166,1906,1107,799,630,702,1332,0.050759219088937095,0.0455531453362256
1659,"Marion County, IA",County or equivalent,33225,33168,-139,3717,3490,227,123,-483,-360,-0.0145372460496614,0.003702031602708804
1660,"Miami County, IN",County or equivalent,36810,35328,-1577,3776,3797,-21,191,-1756,-1565,-0.04770442814452595,0.005188807389296387
1661,"Pearl River County, MS",County or equivalent,55683,55876,150,6500,6629,-129,-109,406,297,0.007291273817861825,-0.0019575094732683226
1662,"Hughes County, SD",County or equivalent,17077,17336,314,2411,1546,865,6,-554,-548,-0.03244129530948059,0.0003513497686947356
1663,"Stanley County, SD",County or equivalent,2972,3121,155,386,197,189,-5,-29,-34,-0.009757738896366084,-0.0016823687752355314
1664,"Moore County, NC",County or equivalent,88595,103352,15102,10874,11355,-481,920,14592,15512,0.16470455443309442,0.01038433320164795
1665,"Crawford County, KS",County or equivalent,39173,38730,-405,4903,4269,634,989,-2020,-1031,-0.05156612973221352,0.02524698133918771
1666,"Hale County, TX",County or equivalent,36271,32754,-3453,4941,3179,1762,40,-5325,-5285,-0.14681150230211465,0.0011028094069642411
1667,"Grant County, WI",County or equivalent,51234,51021,-183,5700,5077,623,280,-1104,-824,-0.0215481906546434,0.00546512081820666
1668,"Clinton County, NY",County or equivalent,82099,79778,-2353,7772,7353,419,871,-3639,-2768,-0.04432453501260673,0.010609142620494769
1669,"Marshall County, IN",County or equivalent,47000,46108,-942,5868,4760,1108,307,-2358,-2051,-0.05017021276595745,0.006531914893617021
1670,"Gallia County, OH",County or equivalent,31066,29802,-1135,3811,3869,-58,227,-1316,-1089,-0.0423614240648941,0.0073070237558745905
1671,"Mason County, WV",County or equivalent,27377,26335,-1023,2807,3568,-761,5,-243,-238,-0.008876063849216496,0.00018263505862585382
1672,"Kay County, OK",County or equivalent,46428,43274,-3288,6119,5984,135,94,-3512,-3418,-0.0756440079262514,0.0020246403032652713
1673,"Livingston County, IL",County or equivalent,38862,35414,-3537,4301,4386,-85,174,-3688,-3514,-0.09489990221810507,0.0044773815037826145
1674,"Butler County, MO",County or equivalent,42785,42178,-614,5589,5869,-280,29,-320,-291,-0.007479256748860581,0.0006778076428654902
1675,"Ripley County, MO",County or equivalent,14102,13300,-806,1740,1950,-210,-13,-573,-586,-0.04063253439228478,-0.0009218550560204226
1676,"Roosevelt County, NM",County or equivalent,20020,18350,-1490,2843,1598,1245,426,-3216,-2790,-0.16063936063936066,0.021278721278721283
1677,"Clallam County, WA",County or equivalent,71505,78067,6671,6677,10155,-3478,752,9396,10148,0.13140339836375078,0.010516747080623732
1678,"Calhoun County, TX",County or equivalent,21312,21001,-379,2925,2134,791,319,-1482,-1163,-0.06953828828828829,0.01496809309309309
1679,"Scioto County, OH",County or equivalent,79672,74347,-5312,8897,10176,-1279,257,-4296,-4039,-0.053921076413294515,0.003225725474445225
1680,"Schuylkill County, PA",County or equivalent,148280,140709,-7572,14070,19867,-5797,406,-2084,-1678,-0.014054491502562721,0.0027380631238198005
1681,"Carbon County, UT",County or equivalent,21403,20760,-643,2825,2270,555,125,-1343,-1218,-0.06274821286735505,0.005840302761295145
1682,"Crook County, OR",County or equivalent,20882,25105,4127,2188,2556,-368,-42,4516,4474,0.21626281007566325,-0.0020113015994636533
1683,"Whitman County, WA",County or equivalent,44795,49500,4722,4297,2727,1570,4141,-1078,3063,-0.024065185846634668,0.09244335305279608
1684,"Adams County, IL",County or equivalent,67158,64783,-2312,8265,8288,-23,250,-2505,-2255,-0.03730009827570803,0.0037225646981744547
1685,"Lewis County, MO",County or equivalent,10206,9810,-395,1193,1152,41,3,-439,-436,-0.04301391338428375,0.00029394473838918284
1686,"Willacy County, TX",County or equivalent,22226,21161,-976,2969,1751,1218,69,-2275,-2206,-0.1023575992081346,0.0031044722397192475
1687,"Tehama County, CA",County or equivalent,63562,64494,1053,7821,6703,1118,-210,192,-18,0.003020672728989019,-0.0033038607973317393
1688,"Goodhue County, MN",County or equivalent,46225,46318,124,5262,4997,265,151,-265,-114,-0.005732828555976203,0.003266630611141157
1689,"Fremont County, ID",County or equivalent,13232,13218,-25,1924,1083,841,67,-946,-879,-0.07149334945586458,0.005063482466747279
1690,"Madison County, ID",County or equivalent,37588,40318,2776,11234,1405,9829,535,-7651,-7116,-0.20354900500159626,0.014233265935937003
1691,"Wayne County, IN",County or equivalent,68897,65778,-3218,8043,8897,-854,542,-2892,-2350,-0.0419757028607922,0.00786681568137945
1692,"Estill County, KY",County or equivalent,14722,14109,-577,1564,1989,-425,3,-149,-146,-0.010120907485396008,0.00020377666077978532
1693,"Madison County, KY",County or equivalent,83471,94265,11355,10259,7692,2567,813,7895,8708,0.09458374764888404,0.009739909669226438
1694,"Starr County, TX",County or equivalent,61140,64266,3284,13176,4055,9121,348,-6218,-5870,-0.10170101406607786,0.005691854759568204
1695,"Fremont County, WY",County or equivalent,40199,39317,-806,5770,4498,1272,-3,-2097,-2100,-0.05216547675315306,-7.462872210751512e-05
1696,"Halifax County, NC",County or equivalent,54476,49479,-5152,5835,6941,-1106,152,-4205,-4053,-0.0771899552096336,0.002790219546222189
1697,"Northampton County, NC",County or equivalent,22037,19088,-3016,1868,2804,-936,96,-2186,-2090,-0.09919680537278214,0.00435630984253755
1698,"Ogle County, IL",County or equivalent,53420,50306,-3188,5454,5165,289,179,-3687,-3508,-0.06901909397229503,0.0033508049419693
1699,"Richmond County, NC",County or equivalent,46636,44332,-2315,5644,5743,-99,25,-2233,-2208,-0.04788146496268977,0.0005360665580238441
1700,"Aransas County, TX",County or equivalent,23189,23814,649,2520,3557,-1037,11,1615,1626,0.06964509034455993,0.0004743628444521108
1701,"Sweetwater County, WY",County or equivalent,43580,42673,-1133,6007,2982,3025,476,-4718,-4242,-0.10826067003212483,0.010922441486920606
1702,"Phelps County, MO",County or equivalent,45298,44414,-711,5171,4610,561,1971,-3272,-1301,-0.07223276965870458,0.043511854828027725
1703,"Douglas County, OR",County or equivalent,107637,111364,3680,11047,14929,-3882,178,7484,7662,0.06952999433280377,0.001653706439235579
1704,"Chaves County, NM",County or equivalent,65721,64711,-937,9148,6798,2350,681,-3950,-3269,-0.06010255473897232,0.010361984753731684
1705,"Lincoln County, NM",County or equivalent,20451,19939,-554,1863,2169,-306,260,-510,-250,-0.024937655860349132,0.012713314752334849
1706,"Pope County, AR",County or equivalent,62110,64334,2580,8093,6086,2007,489,83,572,0.0013363387538238608,0.0078731283207213
1707,"Yell County, AR",County or equivalent,22148,21181,-1004,2820,2663,157,311,-1464,-1153,-0.06610077659382338,0.014041899945819036
1708,"Lincoln Parish, LA",County or equivalent,46854,46552,-188,5731,3931,1800,1334,-3328,-1994,-0.07102915439450208,0.028471421863661587
1709,"Rutland County, VT",County or equivalent,61585,57764,-3895,5327,7037,-1710,110,-2285,-2175,-0.03710319071202403,0.0017861492246488593
1710,"Graham County, AZ",County or equivalent,37154,39211,1999,5677,2970,2707,436,-1172,-736,-0.03154438283899445,0.011734941056144695
1711,"Camden County, GA",County or equivalent,50680,55388,4863,8042,3543,4499,865,-523,342,-0.010319652722967641,0.01706787687450671
1712,"Elk County, PA",County or equivalent,31862,29607,-2339,3025,4005,-980,13,-1367,-1354,-0.04290377251898814,0.000408009541146193
1713,"Columbiana County, OH",County or equivalent,107889,101118,-6732,10888,12831,-1943,309,-5074,-4765,-0.04702981768298901,0.002864054722909657
1714,"Ottawa County, KS",County or equivalent,6097,5712,-379,590,703,-113,12,-275,-263,-0.04510414958176152,0.0019681810726586845
1715,"Saline County, KS",County or equivalent,55781,53926,-1678,7357,5538,1819,177,-3657,-3480,-0.06555995769168714,0.0031731234649791146
1716,"Bonner County, ID",County or equivalent,40904,46817,5940,4169,4430,-261,101,6085,6186,0.14876295716800314,0.0024691961666340697
1717,"Erie County, OH",County or equivalent,76977,73719,-3344,8037,9666,-1629,233,-1904,-1671,-0.024734661002637152,0.003026878158410954
1718,"Lee County, NC",County or equivalent,57879,62353,4504,8129,5861,2268,711,1539,2250,0.026589954905924428,0.012284248172912456
1719,"Chippewa County, MI",County or equivalent,38623,36958,-1718,3497,3779,-282,290,-1743,-1453,-0.045128550345648964,0.007508479403464256
1720,"Bradford County, PA",County or equivalent,62731,60221,-2479,7244,7167,77,254,-2810,-2556,-0.04479443975068148,0.004049034767499323
1721,"Banner County, NE",County or equivalent,695,786,92,69,38,31,15,43,58,0.0618705035971223,0.02158273381294964
1722,"Scotts Bluff County, NE",County or equivalent,37058,35299,-1673,4904,4311,593,197,-2462,-2265,-0.0664363969992984,0.005315991149009661
1723,"Sioux County, NE",County or equivalent,1307,1200,-107,96,71,25,0,-133,-133,-0.10175975516449884,0.0
1724,"Jackson County, AL",County or equivalent,53207,51582,-1666,5805,7135,-1330,151,-448,-297,-0.008419944744112617,0.0028379724472343865
1725,"Scott County, IN",County or equivalent,24172,23788,-407,2855,3198,-343,130,-189,-59,-0.007818964090683436,0.005378123448618236
1726,"White County, AR",County or equivalent,77349,78729,1654,9778,8564,1214,467,-18,449,-0.00023271147655431874,0.006037569975048158
1727,"Pettis County, MO",County or equivalent,42263,42490,289,6000,4510,1490,424,-1602,-1178,-0.037905496533610965,0.010032416061330242
1728,"Snyder County, PA",County or equivalent,39709,40317,598,4314,3679,635,175,-177,-2,-0.004457427787151527,0.0044070613714774975
1729,"Dallas County, AL",County or equivalent,43855,36098,-7715,5148,5519,-371,50,-7431,-7381,-0.16944476114468135,0.0011401208528103981
1730,"Oconee County, SC",County or equivalent,74349,80015,5730,7754,9219,-1465,1008,6195,7203,0.08332324577331235,0.013557680668199977
1731,"Seneca County, NY",County or equivalent,35271,33991,-1262,3844,3556,288,198,-1741,-1543,-0.04936066456862578,0.005613676958407757
1732,"Sevier County, TN",County or equivalent,89921,99244,9532,10740,10470,270,1809,7414,9223,0.08245015068782598,0.020117658833865282
1733,"Jackson County, IN",County or equivalent,42584,44222,1846,6072,4772,1300,901,-339,562,-0.007960736426826978,0.021158181476610933
1734,"Menominee County, WI",County or equivalent,4270,4546,314,955,472,483,74,-249,-175,-0.05831381733021077,0.017330210772833726
1735,"Shawano County, WI",County or equivalent,41938,40786,-1169,4445,4781,-336,103,-910,-807,-0.021698698078115308,0.0024560064857647003
1736,"Pottawatomie County, OK",County or equivalent,69653,72998,3551,9231,8495,736,326,2514,2840,0.03609320488708311,0.004680343990926449
1737,"Cleveland County, NC",County or equivalent,97922,99035,1001,11203,12320,-1117,546,1655,2201,0.01690120708318866,0.005575866505994567
1738,"Bedford County, TN",County or equivalent,45082,50179,5121,6536,4917,1619,638,2865,3503,0.06355086287209973,0.014151989707643847
1739,"Mason County, WA",County or equivalent,60733,68224,7535,6518,6853,-335,1203,6697,7900,0.11026954044753264,0.01980801211861756
1740,"Sheridan County, WY",County or equivalent,29148,30863,1739,3301,3261,40,325,1388,1713,0.047619047619047616,0.01114999313846576
1741,"Navajo County, AZ",County or equivalent,107693,112112,4624,15776,10400,5376,682,-1405,-723,-0.013046344702069772,0.0063328164318943655
1742,"Shelby County, OH",County or equivalent,49347,48337,-1118,6300,4638,1662,586,-3387,-2801,-0.06863639126998601,0.011875088657871806
1743,"Scott County, MO",County or equivalent,39268,38288,-916,5159,4500,659,61,-1615,-1554,-0.04112763573393094,0.001553427727411633
1744,"Grant County, NM",County or equivalent,29386,27007,-2505,2971,3545,-574,127,-2044,-1917,-0.06955693187232015,0.004321785884434765
1745,"Scurry County, TX",County or equivalent,16929,16662,-257,2430,1798,632,129,-1023,-894,-0.06042884990253411,0.007620060251639199
1746,"Pulaski County, KY",County or equivalent,63195,65530,2468,7683,8281,-598,321,2800,3121,0.04430730279294248,0.0050795157844766205
1747,"Somerset County, PA",County or equivalent,77763,72916,-4820,7082,9955,-2873,301,-2191,-1890,-0.028175353317130256,0.003870735439733549
1748,"Tuolumne County, CA",County or equivalent,55164,54515,-829,4727,6688,-1961,323,828,1151,0.015009788992821403,0.0058552679283590744
1749,"Lawrence County, SD",County or equivalent,24204,26221,2131,2345,2352,-7,535,1582,2117,0.06536109733928276,0.02210378449843001
1750,"Clay County, IA",County or equivalent,16633,15976,-691,2007,1962,45,71,-800,-729,-0.04809715625563638,0.004268622617687729
1751,"Dickinson County, IA",County or equivalent,16669,17549,882,1631,2053,-422,128,1192,1320,0.07150998860159577,0.007678924950506929
1752,"Oktibbeha County, MS",County or equivalent,47725,49789,2132,5684,3191,2493,1055,-1457,-402,-0.030529072812991095,0.02210581456259822
1753,"Webster County, MS",County or equivalent,10267,9676,-587,1242,1435,-193,-10,-384,-394,-0.03740138307197818,-0.0009739943508327652
1754,"Bulloch County, GA",County or equivalent,70560,80839,10595,8954,5414,3540,1194,5755,6949,0.08156179138321995,0.01692176870748299
1755,"Routt County, CO",County or equivalent,23434,25560,2054,2205,1121,1084,524,418,942,0.017837330374669284,0.02236067252709738
1756,"Erath County, TX",County or equivalent,37913,43224,5329,4960,3421,1539,120,3635,3755,0.09587740352913247,0.0031651412444280327
1757,"Logan County, CO",County or equivalent,22749,21974,-735,2336,2131,205,31,-977,-946,-0.04294694272275704,0.0013626972614180846
1758,"Whiteside County, IL",County or equivalent,58489,54656,-3849,6432,6721,-289,70,-3630,-3560,-0.0620629520080699,0.0011968062370702186
1759,"Portage County, WI",County or equivalent,70025,71032,1011,6997,5442,1555,1160,-1671,-511,-0.023862906104962514,0.016565512317029633
1760,"Payne County, OK",County or equivalent,77420,81755,4408,9032,5900,3132,4362,-3067,1295,-0.03961508654094549,0.056342030483079314
1761,"Buena Vista County, IA",County or equivalent,20356,19772,-493,3172,1858,1314,900,-2717,-1817,-0.13347415995283946,0.04421300844959717
1762,"St. Joseph County, MI",County or equivalent,61288,60848,-455,8112,6546,1566,338,-2344,-2006,-0.03824565983553061,0.005514945829526171
1763,"Hopkins County, TX",County or equivalent,35211,37170,2004,4720,4056,664,-49,1400,1351,0.03976030217829656,-0.0013916105762403796
1764,"Chattooga County, GA",County or equivalent,25958,24843,-1179,2991,3273,-282,65,-970,-905,-0.037368056090607914,0.0025040449957623853
1765,"Northumberland County, PA",County or equivalent,94287,90258,-4210,9617,12087,-2470,315,-1993,-1678,-0.021137590548007682,0.003340863533679086
1766,"Lassen County, CA",County or equivalent,34828,30016,-4879,3095,2302,793,110,-5902,-5792,-0.16946135293442058,0.003158378316297232
1767,"Nolan County, TX",County or equivalent,15247,14835,-379,2058,1823,235,245,-863,-618,-0.0566012986161212,0.016068734833081917
1768,"Cherokee County, OK",County or equivalent,47126,49019,2027,6089,5202,887,474,682,1156,0.014471841446335357,0.010058142002291728
1769,"Talladega County, AL",County or equivalent,82175,79985,-2363,8850,10320,-1470,408,-1266,-858,-0.015406145421356859,0.004965013690295102
1770,"Taos County, NM",County or equivalent,32897,32593,-340,2980,3065,-85,221,-452,-231,-0.013739854697996778,0.006717937805878957
1771,"Christian County, IL",County or equivalent,34767,32075,-2722,3552,4228,-676,87,-2130,-2043,-0.06126499266545862,0.002502372939856761
1772,"Wasco County, OR",County or equivalent,25282,26403,1192,3090,3205,-115,48,1265,1313,0.050035598449489765,0.0018985839727869629
1773,"Upson County, GA",County or equivalent,27052,26527,-620,3297,3852,-555,24,-87,-63,-0.003216028389767855,0.0008871802454532012
1774,"Thomas County, GA",County or equivalent,44744,44372,-347,5754,5307,447,182,-950,-768,-0.0212318970141248,0.004067584480600751
1775,"Seneca County, OH",County or equivalent,56619,54938,-1805,6008,6142,-134,586,-2253,-1667,-0.039792295872410316,0.010349882548261184
1776,"Tift County, GA",County or equivalent,40250,40719,587,5743,4227,1516,66,-1044,-978,-0.025937888198757763,0.0016397515527950312
1777,"Stephens County, GA",County or equivalent,26124,26107,-55,3157,3619,-462,41,378,419,0.014469453376205787,0.0015694380646149135
1778,"Litchfield County, CT",County or equivalent,189762,179610,-10266,14714,18539,-3825,2479,-8913,-6434,-0.04696936162139944,0.013063732464877057
1779,"Benzie County, MI",County or equivalent,17495,17852,333,1555,2154,-599,-7,947,940,0.05412975135753072,-0.0004001143183766791
1780,"Grand Traverse County, MI",County or equivalent,86975,93592,6604,9325,8749,576,304,5733,6037,0.06591549295774649,0.0034952572578327104
1781,"Kalkaska County, MI",County or equivalent,17146,18003,856,1825,1983,-158,71,947,1018,0.05523154088417123,0.004140907500291613
1782,"Leelanau County, MI",County or equivalent,21718,21743,32,1688,2453,-765,118,689,807,0.03172483654111797,0.0054332811492770975
1783,"Pike County, AL",County or equivalent,32972,32966,64,3833,3352,481,1161,-1613,-452,-0.04892029600873468,0.03521169477132112
1784,"Nevada County, CA",County or equivalent,98795,99606,857,8242,10248,-2006,139,2816,2955,0.028503466774634344,0.0014069537932081585
1785,"Coffee County, TN",County or equivalent,52770,57632,4829,6935,6860,75,80,4705,4785,0.08916050786431684,0.0015160128861095318
1786,"Franklin County, TN",County or equivalent,40960,42485,1421,4084,5111,-1027,335,2124,2459,0.05185546875,0.0081787109375
1787,"Moore County, TN",County or equivalent,6333,6438,93,534,687,-153,55,194,249,0.030633191220590564,0.008684667614084951
1788,"Itawamba County, MS",County or equivalent,23418,23261,-138,2702,2880,-178,46,6,52,0.00025621316935690495,0.0019643009650696045
1789,"Lee County, MS",County or equivalent,82877,85466,2560,11799,9430,2369,437,-206,231,-0.0024856112069693644,0.00527287425944472
1790,"Pontotoc County, MS",County or equivalent,30055,32461,2507,4506,3025,1481,194,828,1022,0.027549492596905676,0.006454832806521377
1791,"Prentiss County, MS",County or equivalent,25232,25013,-268,3191,3054,137,26,-427,-401,-0.016922954977805958,0.001030437539632213
1792,"Mendocino County, CA",County or equivalent,87796,86061,-1789,10379,8825,1554,13,-3288,-3275,-0.03745045332361383,0.0001480705271310766
1793,"Union County, SC",County or equivalent,28914,26991,-1965,3129,3976,-847,-11,-1103,-1114,-0.03814761015425053,-0.00038043854188282494
1794,"Obion County, TN",County or equivalent,31822,30131,-1676,3567,4022,-455,69,-1289,-1220,-0.040506567783294575,0.0021683112312236817
1795,"Champaign County, OH",County or equivalent,40078,38960,-1141,4130,4110,20,106,-1270,-1164,-0.0316882079944109,0.002644842557013823
1796,"Uvalde County, TX",County or equivalent,26441,26742,339,4087,2581,1506,234,-1379,-1145,-0.05215385197231572,0.008849892212851256
1797,"Van Wert County, OH",County or equivalent,28679,28159,-600,3440,3258,182,94,-868,-774,-0.03026604832804491,0.0032776596115624674
1798,"Clay County, SD",County or equivalent,13830,14246,380,1481,1018,463,315,-408,-93,-0.02950108459869848,0.0227765726681128
1799,"Uintah County, UT",County or equivalent,32465,35970,3381,6509,2373,4136,141,-988,-847,-0.030432773756352994,0.004343138764823657
1800,"Wilbarger County, TX",County or equivalent,13509,12552,-983,1690,1607,83,87,-1166,-1079,-0.08631282848471389,0.006440151010437486
1801,"Warren County, MS",County or equivalent,48833,44841,-3929,6241,5342,899,257,-5081,-4824,-0.10404849179857883,0.00526283455859767
1802,"Montgomery County, GA",County or equivalent,9140,9012,-165,1012,903,109,59,-341,-282,-0.03730853391684902,0.006455142231947483
1803,"Toombs County, GA",County or equivalent,27248,26973,-201,3971,3186,785,-52,-921,-973,-0.03380064591896653,-0.0019083969465648852
1804,"Knox County, IN",County or equivalent,38394,36522,-1918,4560,4531,29,147,-2098,-1951,-0.05464395478460176,0.0038287232380059375
1805,"Dukes County, MA",County or equivalent,16573,17461,926,1681,1483,198,212,517,729,0.031195317685391907,0.012791890424183914
1806,"Wabash County, IN",County or equivalent,32850,30784,-2104,3429,4359,-930,96,-1265,-1169,-0.038508371385083714,0.0029223744292237444
1807,"Wilkin County, MN",County or equivalent,6591,6161,-415,731,791,-60,-3,-352,-355,-0.05340615991503565,-0.00045516613563950837
1808,"Richland County, ND",County or equivalent,16329,16156,-165,1875,1443,432,24,-614,-590,-0.03760181272582522,0.0014697776961234616
1809,"Auglaize County, OH",County or equivalent,45914,45680,-253,5630,5007,623,244,-1111,-867,-0.024197412553905128,0.005314283225160082
1810,"Warren County, PA",County or equivalent,41770,38911,-2900,4103,5245,-1142,95,-1834,-1739,-0.043907110366291593,0.0022743595882212114
1811,"Johnson County, MO",County or equivalent,52689,54219,1654,7316,4155,3161,1110,-2640,-1530,-0.05010533507942835,0.02106701588566873
1812,"Kosciusko County, IN",County or equivalent,77338,78988,1633,10479,7262,3217,746,-2270,-1524,-0.029351677053970883,0.009645969639763118
1813,"Daviess County, IN",County or equivalent,31721,33505,1851,5572,3461,2111,149,-391,-242,-0.012326219223858013,0.004697203745153054
1814,"Beaufort County, NC",County or equivalent,47826,47073,-711,4794,6063,-1269,141,456,597,0.009534562790114163,0.002948187178522143
1815,"Fayette County, OH",County or equivalent,29016,28579,-455,3515,3701,-186,158,-410,-252,-0.014130135097877031,0.005445271574303833
1816,"Codington County, SD",County or equivalent,27212,28186,961,3685,2516,1169,366,-562,-196,-0.02065265324121711,0.013449948552109363
1817,"Hamlin County, SD",County or equivalent,5915,6234,335,1221,680,541,123,-331,-208,-0.055959425190194416,0.020794590025359255
1818,"Jefferson County, WI",County or equivalent,83727,85038,1346,8806,6899,1907,319,-833,-514,-0.00994900091965555,0.0038100015526652095
1819,"Hardee County, FL",County or equivalent,27731,26822,-915,3861,2188,1673,362,-2978,-2616,-0.10738884281129422,0.013053982907215751
1820,"Pierce County, GA",County or equivalent,18813,19522,762,2484,2122,362,-21,428,407,0.022750225907617074,-0.001116249402009249
1821,"Ware County, GA",County or equivalent,36308,35826,-472,5029,4717,312,97,-890,-793,-0.02451250413132092,0.0026715875289192465
1822,"Custer County, OK",County or equivalent,27583,28648,1106,4470,3019,1451,433,-806,-373,-0.029220896929268023,0.01569807490120726
1823,"Howell County, MO",County or equivalent,40544,40262,-116,5216,5241,-25,97,-161,-64,-0.003970994475138122,0.002392462509865825
1824,"Clay County, MS",County or equivalent,20569,19352,-1306,2349,2406,-57,39,-1286,-1247,-0.06252126987213769,0.0018960571734163059
1825,"Walworth County, WI",County or equivalent,102195,103953,1731,10261,9515,746,127,914,1041,0.00894368609031753,0.0012427222466852585
1826,"Williams County, ND",County or equivalent,22591,38700,16301,6442,2370,4072,417,11424,11841,0.5056881058828737,0.01845867823469523
1827,"Kandiyohi County, MN",County or equivalent,42231,43130,893,5912,3989,1923,1792,-2819,-1027,-0.06675191210248396,0.04243328360682911
1828,"Clinton County, OH",County or equivalent,41922,41921,-125,5067,4597,470,195,-780,-585,-0.018605982539001,0.00465149563475025
1829,"Wilson County, NC",County or equivalent,81294,81979,754,9878,8909,969,710,-870,-160,-0.010701896818953428,0.008733731886732108
1830,"Cowley County, KS",County or equivalent,36314,34628,-1681,4400,4436,-36,347,-1996,-1649,-0.05496502726221292,0.009555543316627195
1831,"Humboldt County, NV",County or equivalent,16580,16962,443,2594,1295,1299,57,-945,-888,-0.056996381182147164,0.0034378769601930035
1832,"Winona County, MN",County or equivalent,51432,50485,-976,4822,4258,564,673,-2223,-1550,-0.04322211852543164,0.01308523876186032
1833,"Wood County, WI",County or equivalent,74812,72560,-2190,8398,8139,259,238,-2681,-2443,-0.03583649681869218,0.0031813078115810298
1834,"Ellis County, OK",County or equivalent,4158,3830,-321,451,570,-119,44,-250,-206,-0.06012506012506012,0.01058201058201058
1835,"Woodward County, OK",County or equivalent,19996,19812,-272,2974,2065,909,279,-1492,-1213,-0.07461492298459692,0.013952790558111624
1836,"Wayne County, OH",County or equivalent,114409,115694,1163,15523,11499,4024,1003,-3818,-2815,-0.03337150049384227,0.008766792822243005
1837,"Nobles County, MN",County or equivalent,21424,21400,22,3797,1828,1969,1436,-3407,-1971,-0.15902725914861834,0.06702763256161315
1838,"Yankton County, SD",County or equivalent,22436,22742,304,2729,2363,366,102,-146,-44,-0.006507398823319665,0.004546264931360314
1839,"Muskingum County, OH",County or equivalent,86213,86020,-66,10486,10090,396,509,-922,-413,-0.010694442833447393,0.005903981998074536
1840,"Zapata County, TX",County or equivalent,14086,14172,154,2692,951,1741,35,-1629,-1594,-0.1156467414454068,0.002484736617918501
